"date","geography","geography code","Rural Urban","Tenure: All categories: Tenure; measures: Value","Tenure: Owned: Total; measures: Value","Tenure: Owned: Owned outright; measures: Value","Tenure: Owned: Owned with a mortgage or loan; measures: Value","Tenure: Shared ownership (part owned and part rented); measures: Value","Tenure: Social rented: Total; measures: Value","Tenure: Social rented: Rented from council (Local Authority); measures: Value","Tenure: Social rented: Other social rented; measures: Value","Tenure: Private rented: Total; measures: Value","Tenure: Private rented: Private landlord or letting agency; measures: Value","Tenure: Private rented: Employer of a household member; measures: Value","Tenure: Private rented: Relative or friend of household member; measures: Value","Tenure: Private rented: Other; measures: Value","Tenure: Living rent free; measures: Value"
"2011","Darlington 001","E02002559","Total",3646,2827,1211,1616,14,162,135,27,596,455,64,39,38,47
"2011","Darlington 002","E02002560","Total",2511,2107,922,1185,2,73,59,14,311,275,1,35,0,18
"2011","Darlington 003","E02002561","Total",2507,1985,931,1054,6,286,99,187,215,188,2,21,4,15
"2011","Darlington 004","E02002562","Total",2933,1448,570,878,2,686,504,182,772,737,1,29,5,25
"2011","Darlington 005","E02002563","Total",2343,1546,669,877,8,557,469,88,203,180,0,23,0,29
"2011","Darlington 006","E02002564","Total",4137,2484,996,1488,38,1233,963,270,355,311,1,39,4,27
"2011","Darlington 007","E02002565","Total",2667,1722,724,998,4,29,10,19,878,818,5,55,0,34
"2011","Darlington 008","E02002566","Total",3475,1278,511,767,6,558,222,336,1585,1486,21,63,15,48
"2011","Darlington 009","E02002567","Total",3209,1761,882,879,6,890,719,171,522,472,0,45,5,30
"2011","Darlington 010","E02002568","Total",2634,1970,996,974,9,192,71,121,439,410,2,23,4,24
"2011","Darlington 011","E02002569","Total",3912,3475,2089,1386,24,141,17,124,226,196,3,24,3,46
"2011","Darlington 012","E02002570","Total",3723,1944,806,1138,10,823,622,201,906,855,3,39,9,40
"2011","Darlington 013","E02002571","Total",2758,1625,641,984,15,648,605,43,446,396,1,43,6,24
"2011","Darlington 014","E02002572","Total",2727,1361,571,790,16,699,566,133,630,584,3,41,2,21
"2011","Darlington 015","E02002573","Total",3488,2756,1291,1465,18,251,177,74,429,395,5,27,2,34
"2011","County Durham 002","E02004290","Total",2518,2135,904,1231,1,178,48,130,189,161,1,27,0,15
"2011","County Durham 005","E02004291","Total",3131,1946,771,1175,9,714,296,418,434,404,0,23,7,28
"2011","County Durham 007","E02004292","Total",3523,2800,1510,1290,18,365,131,234,303,268,3,31,1,37
"2011","County Durham 011","E02004293","Total",4412,2221,833,1388,29,1741,669,1072,380,331,1,34,14,41
"2011","County Durham 013","E02004294","Total",3655,3208,1533,1675,5,36,13,23,375,340,1,33,1,31
"2011","County Durham 015","E02004295","Total",3213,2297,1026,1271,5,573,203,370,305,278,0,22,5,33
"2011","County Durham 019","E02004296","Total",3529,2352,983,1369,7,843,351,492,289,260,2,24,3,38
"2011","County Durham 001","E02004297","Total",3550,2747,1184,1563,10,431,224,207,323,287,1,32,3,39
"2011","County Durham 003","E02004298","Total",4178,3276,1607,1669,3,472,214,258,388,344,1,39,4,39
"2011","County Durham 004","E02004299","Total",3758,2546,1090,1456,2,689,365,324,490,438,2,42,8,31
"2011","County Durham 006","E02004300","Total",3491,2016,927,1089,5,1039,585,454,408,375,0,29,4,23
"2011","County Durham 008","E02004301","Total",3913,1985,798,1187,3,1424,837,587,462,421,1,33,7,39
"2011","County Durham 009","E02004302","Total",3530,2290,1072,1218,3,411,165,246,787,725,0,52,10,39
"2011","County Durham 010","E02004303","Total",5253,3693,1590,2103,22,542,165,377,938,850,6,70,12,58
"2011","County Durham 012","E02004304","Total",3896,2727,1176,1551,2,663,296,367,464,419,1,36,8,40
"2011","County Durham 014","E02004305","Total",3816,2336,985,1351,3,1008,403,605,423,373,4,36,10,46
"2011","County Durham 020","E02004306","Total",2681,2085,1158,927,3,355,190,165,198,168,6,23,1,40
"2011","County Durham 024","E02004307","Total",2878,2030,953,1077,20,475,225,250,320,286,2,31,1,33
"2011","County Durham 022","E02004308","Total",2987,2582,1333,1249,12,84,27,57,284,249,1,31,3,25
"2011","County Durham 023","E02004309","Total",2769,1756,797,959,7,609,491,118,382,349,1,25,7,15
"2011","County Durham 026","E02004310","Total",3526,2253,963,1290,6,899,789,110,338,294,1,37,6,30
"2011","County Durham 027","E02004311","Total",4118,2780,1200,1580,18,986,877,109,302,263,2,31,6,32
"2011","County Durham 028","E02004312","Total",3409,2901,1702,1199,2,151,140,11,326,294,2,28,2,29
"2011","County Durham 029","E02004313","Total",2957,1118,595,523,9,1159,640,519,653,616,2,27,8,18
"2011","County Durham 030","E02004314","Total",2363,754,504,250,10,387,260,127,1136,1068,19,27,22,76
"2011","County Durham 033","E02004315","Total",3845,2767,1444,1323,7,79,41,38,953,904,4,37,8,39
"2011","County Durham 031","E02004316","Total",2644,1742,785,957,12,542,465,77,319,285,0,32,2,29
"2011","County Durham 038","E02004317","Total",3554,1948,856,1092,2,1283,1051,232,281,250,2,29,0,40
"2011","County Durham 041","E02004318","Total",2666,1823,845,978,11,480,391,89,321,293,1,26,1,31
"2011","County Durham 044","E02004319","Total",3293,2254,988,1266,1,724,655,69,289,251,2,31,5,25
"2011","County Durham 016","E02004320","Total",3851,2890,1194,1696,5,551,449,102,337,293,7,36,1,68
"2011","County Durham 017","E02004321","Total",3662,2438,1132,1306,3,540,417,123,635,585,3,46,1,46
"2011","County Durham 018","E02004322","Total",3769,1716,782,934,3,1634,1326,308,345,301,2,33,9,71
"2011","County Durham 021","E02004323","Total",3337,2369,1047,1322,4,456,321,135,462,429,4,26,3,46
"2011","County Durham 025","E02004324","Total",2588,1766,864,902,1,345,166,179,445,409,0,29,7,31
"2011","County Durham 032","E02004325","Total",3722,1858,753,1105,12,1377,1231,146,404,375,0,26,3,71
"2011","County Durham 034","E02004326","Total",2713,1669,798,871,5,714,501,213,275,246,0,27,2,50
"2011","County Durham 036","E02004327","Total",2913,1683,860,823,5,672,321,351,498,461,0,29,8,55
"2011","County Durham 035","E02004328","Total",3115,1975,772,1203,5,789,721,68,298,271,1,25,1,48
"2011","County Durham 037","E02004329","Total",2807,2116,878,1238,4,470,417,53,181,156,1,18,6,36
"2011","County Durham 039","E02004330","Total",2742,1873,1016,857,3,520,315,205,320,288,2,21,9,26
"2011","County Durham 040","E02004331","Total",3084,1921,918,1003,2,784,621,163,311,291,3,16,1,66
"2011","County Durham 043","E02004332","Total",3113,2200,984,1216,4,538,499,39,316,281,4,29,2,55
"2011","County Durham 047","E02004333","Total",3195,2446,1250,1196,11,511,269,242,198,167,2,26,3,29
"2011","County Durham 048","E02004334","Total",3192,2111,894,1217,5,721,504,217,331,301,2,25,3,24
"2011","County Durham 049","E02004335","Total",2929,1375,643,732,10,1029,588,441,485,459,0,23,3,30
"2011","County Durham 050","E02004336","Total",3264,1790,828,962,3,1028,727,301,411,367,1,32,11,32
"2011","County Durham 052","E02004337","Total",4037,2691,1215,1476,5,832,484,348,452,414,0,31,7,57
"2011","County Durham 053","E02004338","Total",3029,1920,878,1042,8,624,401,223,446,411,6,27,2,31
"2011","County Durham 054","E02004339","Total",2997,2364,1263,1101,5,306,186,120,289,262,5,20,2,33
"2011","County Durham 059","E02004340","Total",4812,2690,1291,1399,5,1250,815,435,808,756,2,43,7,59
"2011","County Durham 060","E02004341","Total",3474,2859,1096,1763,10,295,133,162,291,266,2,18,5,19
"2011","County Durham 061","E02004342","Total",2401,892,274,618,11,1099,782,317,383,354,0,28,1,16
"2011","County Durham 062","E02004343","Total",2492,1493,615,878,11,759,490,269,204,169,1,30,4,25
"2011","County Durham 063","E02004344","Total",3244,2034,994,1040,4,871,575,296,309,268,5,33,3,26
"2011","County Durham 064","E02004345","Total",5755,4036,2355,1681,15,750,205,545,816,736,14,52,14,138
"2011","County Durham 065","E02004346","Total",2344,1537,1015,522,12,156,36,120,539,481,11,38,9,100
"2011","County Durham 066","E02004347","Total",3012,2026,1243,783,13,497,37,460,422,379,3,36,4,54
"2011","County Durham 042","E02004348","Total",3700,2718,1591,1127,10,410,279,131,457,386,8,55,8,105
"2011","County Durham 045","E02004349","Total",4081,2354,1117,1237,2,1259,707,552,403,359,2,38,4,63
"2011","County Durham 046","E02004350","Total",4378,3278,1599,1679,7,381,233,148,646,571,10,58,7,66
"2011","County Durham 051","E02004351","Total",3135,1661,784,877,1,1127,864,263,308,271,4,32,1,38
"2011","County Durham 055","E02004352","Total",3409,2184,1038,1146,24,348,225,123,816,747,6,52,11,37
"2011","County Durham 056","E02004353","Total",3313,2725,1425,1300,1,134,19,115,410,382,0,27,1,43
"2011","County Durham 057","E02004354","Total",3891,2684,1192,1492,6,639,567,72,518,467,3,43,5,44
"2011","County Durham 058","E02004355","Total",3247,1637,725,912,6,1246,921,325,313,295,2,15,1,45
"2011","Hartlepool 001","E02002483","Total",3847,2890,1098,1792,58,559,206,353,308,275,1,30,2,32
"2011","Hartlepool 002","E02002484","Total",4553,1754,734,1020,22,2147,918,1229,558,510,4,34,10,72
"2011","Hartlepool 003","E02002485","Total",3474,1689,730,959,35,1244,609,635,462,435,0,26,1,44
"2011","Hartlepool 005","E02002487","Total",2765,1048,455,593,26,445,57,388,1211,1157,6,42,6,35
"2011","Hartlepool 006","E02002488","Total",2512,2104,1019,1085,1,139,12,127,238,218,1,16,3,30
"2011","Hartlepool 007","E02002489","Total",3532,1627,668,959,9,773,261,512,1059,1011,2,31,15,64
"2011","Hartlepool 008","E02002490","Total",2857,1605,741,864,3,496,86,410,720,683,3,29,5,33
"2011","Hartlepool 009","E02002491","Total",2887,1639,824,815,21,918,520,398,246,209,2,28,7,63
"2011","Hartlepool 010","E02002492","Total",2924,1772,754,1018,2,833,398,435,265,229,1,31,4,52
"2011","Hartlepool 011","E02002493","Total",2698,2240,1152,1088,7,215,56,159,207,181,1,21,4,29
"2011","Hartlepool 012","E02002494","Total",3399,1483,688,795,7,1485,818,667,373,350,0,20,3,51
"2011","Hartlepool 014","E02006909","Total",4986,4343,2227,2116,9,261,75,186,324,267,5,41,11,49
"2011","Middlesbrough 001","E02002496","Total",4349,1183,610,573,25,1278,228,1050,1752,1655,7,54,36,111
"2011","Middlesbrough 002","E02002497","Total",2815,1100,465,635,16,877,487,390,744,712,3,22,7,78
"2011","Middlesbrough 003","E02002498","Total",3820,1223,629,594,18,680,263,417,1813,1723,2,52,36,86
"2011","Middlesbrough 004","E02002499","Total",3005,1343,561,782,14,1264,862,402,319,290,2,20,7,65
"2011","Middlesbrough 005","E02002500","Total",2339,1509,650,859,14,180,56,124,601,558,4,37,2,35
"2011","Middlesbrough 006","E02002501","Total",2228,1123,442,681,6,773,329,444,283,255,0,21,7,43
"2011","Middlesbrough 007","E02002502","Total",4180,1656,755,901,7,1987,1275,712,427,370,4,46,7,103
"2011","Middlesbrough 008","E02002503","Total",2567,1431,563,868,27,798,356,442,277,238,1,33,5,34
"2011","Middlesbrough 009","E02002504","Total",3719,2733,1191,1542,60,130,24,106,740,692,0,43,5,56
"2011","Middlesbrough 010","E02002505","Total",2531,1133,420,713,13,1053,670,383,274,242,1,20,11,58
"2011","Middlesbrough 011","E02002506","Total",2426,850,325,525,6,1167,381,786,359,223,70,21,45,44
"2011","Middlesbrough 012","E02002507","Total",2498,2161,1129,1032,4,41,16,25,265,230,0,33,2,27
"2011","Middlesbrough 013","E02002508","Total",2118,1878,1089,789,2,51,10,41,166,145,0,20,1,21
"2011","Middlesbrough 014","E02002509","Total",2343,1564,724,840,7,453,250,203,281,260,0,19,2,38
"2011","Middlesbrough 015","E02002510","Total",2482,2217,1279,938,9,46,11,35,194,170,0,20,4,16
"2011","Middlesbrough 017","E02002512","Total",2205,1929,943,986,26,75,8,67,153,131,0,19,3,22
"2011","Middlesbrough 018","E02002513","Total",3824,1975,848,1127,8,1473,498,975,316,282,3,26,5,52
"2011","Middlesbrough 019","E02002514","Total",3827,2238,683,1555,54,1222,308,914,254,218,1,28,7,59
"2011","Middlesbrough 020","E02006811","Total",3927,3477,1894,1583,20,106,17,89,291,254,0,36,1,33
"2011","Northumberland 004","E02005702","Total",2690,1704,1018,686,8,260,136,124,634,456,93,14,71,84
"2011","Northumberland 005","E02005703","Total",3150,1677,873,804,10,934,645,289,437,397,4,24,12,92
"2011","Northumberland 006","E02005704","Total",5508,3855,2073,1782,18,933,683,250,626,547,12,56,11,76
"2011","Northumberland 007","E02005705","Total",3407,2211,1329,882,14,367,217,150,661,550,39,48,24,154
"2011","Northumberland 001","E02005706","Total",4329,2253,1168,1085,14,1293,351,942,694,623,13,55,3,75
"2011","Northumberland 002","E02005707","Total",3123,2222,1391,831,12,334,69,265,463,404,24,26,9,92
"2011","Northumberland 003","E02005708","Total",5013,2865,1853,1012,18,717,223,494,1110,989,43,64,14,303
"2011","Northumberland 022","E02005709","Total",2984,1079,439,640,8,1561,1261,300,271,239,6,18,8,65
"2011","Northumberland 023","E02005710","Total",4067,2339,1055,1284,9,730,397,333,930,831,6,85,8,59
"2011","Northumberland 024","E02005711","Total",3680,1865,884,981,5,1468,1223,245,300,264,1,31,4,42
"2011","Northumberland 025","E02005712","Total",2914,1908,780,1128,8,621,537,84,344,308,4,27,5,33
"2011","Northumberland 026","E02005713","Total",2736,2536,1069,1467,8,16,8,8,166,137,2,25,2,10
"2011","Northumberland 027","E02005714","Total",2003,1915,624,1291,13,7,2,5,64,58,0,6,0,4
"2011","Northumberland 029","E02005715","Total",3714,1890,817,1073,24,1387,772,615,361,322,4,32,3,52
"2011","Northumberland 028","E02005716","Total",3732,2646,990,1656,1,710,634,76,331,284,3,41,3,44
"2011","Northumberland 030","E02005717","Total",3598,2575,1280,1295,4,720,635,85,241,202,1,32,6,58
"2011","Northumberland 031","E02005718","Total",3085,2583,1373,1210,3,153,112,41,322,281,1,38,2,24
"2011","Northumberland 032","E02005719","Total",3536,2149,914,1235,31,890,701,189,418,374,5,35,4,48
"2011","Northumberland 008","E02005720","Total",4822,3270,1534,1736,6,924,531,393,567,510,6,44,7,55
"2011","Northumberland 011","E02005721","Total",2140,1429,613,816,1,411,185,226,273,243,4,23,3,26
"2011","Northumberland 015","E02005722","Total",2990,2059,1082,977,4,174,71,103,618,572,16,22,8,135
"2011","Northumberland 016","E02005723","Total",3124,1870,1030,840,19,817,407,410,353,301,5,41,6,65
"2011","Northumberland 018","E02005724","Total",2548,2343,1373,970,2,49,27,22,131,116,2,10,3,23
"2011","Northumberland 033","E02005725","Total",2792,2261,1360,901,7,209,105,104,266,242,3,19,2,49
"2011","Northumberland 034","E02005726","Total",3008,2477,1452,1025,4,128,49,79,339,266,34,12,27,60
"2011","Northumberland 019","E02005727","Total",2839,1749,1003,746,23,345,98,247,617,522,28,47,20,105
"2011","Northumberland 037","E02005728","Total",3172,2097,1301,796,7,459,171,288,516,465,8,31,12,93
"2011","Northumberland 036","E02005729","Total",2395,1804,959,845,8,249,89,160,284,253,6,22,3,50
"2011","Northumberland 035","E02005730","Total",5725,3838,2183,1655,49,984,387,597,765,677,10,68,10,89
"2011","Northumberland 038","E02005731","Total",4533,3098,1253,1845,23,1022,544,478,350,305,2,42,1,40
"2011","Northumberland 039","E02005732","Total",3905,2917,1716,1201,29,332,91,241,551,502,12,27,10,76
"2011","Northumberland 040","E02005733","Total",3487,2346,1385,961,37,375,104,271,628,555,9,47,17,101
"2011","Northumberland 009","E02005734","Total",2853,1634,871,763,17,772,413,359,398,366,4,25,3,32
"2011","Northumberland 010","E02005735","Total",3621,2021,1011,1010,3,525,93,432,1037,966,5,53,13,35
"2011","Northumberland 013","E02005736","Total",3369,1620,672,948,12,1280,797,483,418,379,5,24,10,39
"2011","Northumberland 012","E02005737","Total",3232,2105,892,1213,4,787,413,374,311,277,1,30,3,25
"2011","Northumberland 014","E02005738","Total",2188,1777,806,971,7,184,92,92,202,175,3,22,2,18
"2011","Northumberland 017","E02005739","Total",4257,2915,1358,1557,8,862,468,394,429,396,1,27,5,43
"2011","Northumberland 020","E02005740","Total",4677,2676,1122,1554,8,1273,775,498,675,602,2,63,8,45
"2011","Northumberland 021","E02005741","Total",3588,2629,1180,1449,24,579,304,275,316,269,7,32,8,40
"2011","Redcar and Cleveland 001","E02002515","Total",3270,1817,830,987,13,230,42,188,1172,1090,2,71,9,38
"2011","Redcar and Cleveland 002","E02002516","Total",2432,1544,705,839,9,634,319,315,222,189,3,25,5,23
"2011","Redcar and Cleveland 003","E02002517","Total",2386,1449,685,764,4,697,364,333,198,170,1,20,7,38
"2011","Redcar and Cleveland 004","E02002518","Total",4510,3828,1777,2051,50,156,70,86,420,375,0,40,5,56
"2011","Redcar and Cleveland 005","E02002519","Total",3153,1607,748,859,9,1301,628,673,211,180,0,23,8,25
"2011","Redcar and Cleveland 006","E02002520","Total",5772,4664,2474,2190,38,490,192,298,519,460,3,48,8,61
"2011","Redcar and Cleveland 007","E02002521","Total",2865,1864,1007,857,2,385,95,290,585,536,10,37,2,29
"2011","Redcar and Cleveland 009","E02002523","Total",2716,791,288,503,11,1574,1005,569,321,302,0,16,3,19
"2011","Redcar and Cleveland 010","E02002524","Total",2291,1670,836,834,6,316,151,165,283,261,2,15,5,16
"2011","Redcar and Cleveland 011","E02002525","Total",3772,2475,1118,1357,22,815,428,387,431,383,2,37,9,29
"2011","Redcar and Cleveland 012","E02002526","Total",3189,2111,910,1201,22,529,294,235,494,455,4,31,4,33
"2011","Redcar and Cleveland 013","E02002527","Total",2254,1285,680,605,4,478,227,251,465,428,1,26,10,22
"2011","Redcar and Cleveland 015","E02002529","Total",2620,1727,847,880,2,651,405,246,214,186,2,21,5,26
"2011","Redcar and Cleveland 016","E02002530","Total",2881,1832,1034,798,4,640,312,328,363,325,11,20,7,42
"2011","Redcar and Cleveland 018","E02002532","Total",2933,1582,740,842,17,766,401,365,516,460,6,44,6,52
"2011","Redcar and Cleveland 019","E02002533","Total",2437,2099,1139,960,0,112,68,44,206,179,3,23,1,20
"2011","Redcar and Cleveland 020","E02002534","Total",2469,2249,1338,911,0,24,10,14,166,144,4,18,0,30
"2011","Redcar and Cleveland 021","E02006812","Total",3354,2318,1241,1077,27,710,402,308,269,234,1,29,5,30
"2011","Redcar and Cleveland 022","E02006910","Total",4301,2793,1409,1384,16,1060,586,474,379,341,0,34,4,53
"2011","Stockton-on-Tees 001","E02002535","Total",4062,3539,1421,2118,20,160,44,116,319,283,0,34,2,24
"2011","Stockton-on-Tees 002","E02002536","Total",4239,2872,1393,1479,11,769,479,290,559,497,2,51,9,28
"2011","Stockton-on-Tees 003","E02002537","Total",3673,2050,813,1237,6,1104,802,302,494,450,1,35,8,19
"2011","Stockton-on-Tees 004","E02002538","Total",2429,1520,570,950,3,524,255,269,367,332,5,20,10,15
"2011","Stockton-on-Tees 005","E02002539","Total",3517,3124,1519,1605,3,124,74,50,225,192,2,30,1,41
"2011","Stockton-on-Tees 006","E02002540","Total",2808,2449,1279,1170,24,121,3,118,192,167,0,25,0,22
"2011","Stockton-on-Tees 007","E02002541","Total",2870,2058,947,1111,2,282,147,135,490,428,2,57,3,38
"2011","Stockton-on-Tees 008","E02002542","Total",3358,1906,696,1210,7,1075,721,354,349,309,0,34,6,21
"2011","Stockton-on-Tees 009","E02002543","Total",3356,1576,467,1109,30,1409,846,563,327,280,3,34,10,14
"2011","Stockton-on-Tees 010","E02002544","Total",3391,1772,772,1000,6,949,461,488,633,594,1,37,1,31
"2011","Stockton-on-Tees 011","E02002545","Total",2294,2021,978,1043,7,76,37,39,175,152,0,22,1,15
"2011","Stockton-on-Tees 012","E02002546","Total",3103,1644,674,970,9,886,529,357,543,485,2,51,5,21
"2011","Stockton-on-Tees 013","E02002547","Total",2765,2263,1210,1053,13,311,125,186,156,124,0,24,8,22
"2011","Stockton-on-Tees 014","E02002548","Total",4986,1669,597,1072,18,1815,991,824,1413,1332,4,51,26,71
"2011","Stockton-on-Tees 015","E02002549","Total",3361,2951,1605,1346,13,153,66,87,208,183,2,21,2,36
"2011","Stockton-on-Tees 016","E02002550","Total",2670,1942,983,959,5,335,55,280,357,329,1,25,2,31
"2011","Stockton-on-Tees 017","E02002551","Total",2739,1003,373,630,8,792,257,535,901,865,5,27,4,35
"2011","Stockton-on-Tees 018","E02002552","Total",2798,1725,632,1093,11,773,395,378,277,234,0,36,7,12
"2011","Stockton-on-Tees 019","E02002553","Total",2585,1621,765,856,5,563,355,208,371,320,2,36,13,25
"2011","Stockton-on-Tees 020","E02002554","Total",2355,1196,610,586,11,870,489,381,251,219,0,25,7,27
"2011","Stockton-on-Tees 021","E02002555","Total",4137,3429,1677,1752,7,206,72,134,459,415,1,33,10,36
"2011","Stockton-on-Tees 022","E02002556","Total",2726,2420,889,1531,17,20,13,7,245,225,1,17,2,24
"2011","Stockton-on-Tees 023","E02002557","Total",4792,4194,748,3446,12,31,3,28,540,506,2,30,2,15
"2011","Stockton-on-Tees 024","E02002558","Total",4145,3281,1667,1614,7,277,66,211,536,496,5,33,2,44
"2011","Gateshead 001","E02001682","Total",3431,2405,1128,1277,10,770,524,246,218,189,0,28,1,28
"2011","Gateshead 002","E02001683","Total",4002,3072,1419,1653,14,442,392,50,451,406,4,36,5,23
"2011","Gateshead 003","E02001684","Total",3311,1402,585,817,26,1324,1049,275,528,471,0,43,14,31
"2011","Gateshead 004","E02001685","Total",3612,1811,627,1184,28,1463,1258,205,282,254,1,22,5,28
"2011","Gateshead 005","E02001686","Total",3168,2392,1141,1251,8,477,430,47,263,234,3,24,2,28
"2011","Gateshead 007","E02001688","Total",3799,1381,410,971,32,1703,1401,302,646,588,1,50,7,37
"2011","Gateshead 008","E02001689","Total",3351,1255,500,755,17,985,583,402,1058,991,5,54,8,36
"2011","Gateshead 009","E02001690","Total",3325,2136,974,1162,7,714,539,175,430,395,4,28,3,38
"2011","Gateshead 010","E02001691","Total",3876,1737,730,1007,7,591,349,242,1502,1417,9,72,4,39
"2011","Gateshead 011","E02001692","Total",2765,1021,355,666,14,1442,759,683,273,237,2,27,7,15
"2011","Gateshead 012","E02001693","Total",2633,1131,466,665,5,1274,1019,255,205,174,2,25,4,18
"2011","Gateshead 013","E02001694","Total",2814,2017,902,1115,7,483,397,86,284,243,0,40,1,23
"2011","Gateshead 014","E02001695","Total",2702,2041,809,1232,3,481,395,86,165,150,0,14,1,12
"2011","Gateshead 015","E02001696","Total",4065,2082,875,1207,3,1749,1425,324,191,170,1,15,5,40
"2011","Gateshead 016","E02001697","Total",3386,2589,1120,1469,26,402,347,55,343,315,0,27,1,26
"2011","Gateshead 017","E02001698","Total",3202,2839,1724,1115,4,162,133,29,166,147,0,18,1,31
"2011","Gateshead 018","E02001699","Total",3124,1828,771,1057,14,1039,826,213,218,185,1,28,4,25
"2011","Gateshead 019","E02001700","Total",4585,3422,1501,1921,9,794,694,100,313,281,1,30,1,47
"2011","Gateshead 020","E02001701","Total",2763,2323,1201,1122,19,163,79,84,230,200,1,27,2,28
"2011","Gateshead 021","E02001702","Total",3522,1361,587,774,6,1951,1659,292,179,153,0,19,7,25
"2011","Gateshead 022","E02001703","Total",2435,1818,947,871,23,459,419,40,125,103,3,15,4,10
"2011","Gateshead 023","E02001704","Total",3380,1755,805,950,4,1397,1334,63,184,154,0,29,1,40
"2011","Gateshead 024","E02001705","Total",3200,2048,1051,997,6,619,568,51,492,464,3,22,3,35
"2011","Gateshead 025","E02001706","Total",2924,1579,697,882,4,1123,981,142,184,159,0,24,1,34
"2011","Gateshead 026","E02001707","Total",3599,2251,980,1271,38,886,738,148,386,356,1,29,0,38
"2011","Gateshead 027","E02006841","Total",3949,1060,296,764,26,1585,1417,168,1224,1152,4,62,6,54
"2011","Gateshead 028","E02006842","Total",2231,1159,480,679,3,463,270,193,585,542,1,36,6,21
"2011","Newcastle upon Tyne 001","E02001708","Total",4122,2980,1286,1694,4,643,512,131,470,430,2,33,5,25
"2011","Newcastle upon Tyne 002","E02001709","Total",4218,3215,1539,1676,7,179,161,18,792,756,5,31,0,25
"2011","Newcastle upon Tyne 003","E02001710","Total",4381,2138,989,1149,25,1732,1538,194,425,383,1,38,3,61
"2011","Newcastle upon Tyne 004","E02001711","Total",4129,2076,874,1202,27,1648,1492,156,325,292,4,25,4,53
"2011","Newcastle upon Tyne 005","E02001712","Total",4214,2882,1367,1515,23,453,367,86,813,717,5,49,42,43
"2011","Newcastle upon Tyne 006","E02001713","Total",4389,3270,1607,1663,15,462,322,140,602,564,8,27,3,40
"2011","Newcastle upon Tyne 007","E02001714","Total",3901,3168,1443,1725,10,173,156,17,504,441,6,53,4,46
"2011","Newcastle upon Tyne 008","E02001715","Total",4712,2248,893,1355,53,1888,1648,240,462,412,1,46,3,61
"2011","Newcastle upon Tyne 011","E02001718","Total",2427,1204,467,737,4,979,849,130,201,156,19,22,4,39
"2011","Newcastle upon Tyne 012","E02001719","Total",3759,2707,1300,1407,7,463,433,30,527,479,3,42,3,55
"2011","Newcastle upon Tyne 013","E02001720","Total",3343,1251,663,588,22,165,48,117,1863,1784,2,60,17,42
"2011","Newcastle upon Tyne 014","E02001721","Total",4647,2810,1288,1522,6,1352,1057,295,424,380,4,38,2,55
"2011","Newcastle upon Tyne 015","E02001722","Total",4195,2455,1122,1333,14,1364,1202,162,301,250,0,47,4,61
"2011","Newcastle upon Tyne 016","E02001723","Total",2575,1413,556,857,4,721,669,52,410,371,1,35,3,27
"2011","Newcastle upon Tyne 017","E02001724","Total",3575,1236,632,604,60,363,73,290,1879,1788,2,70,19,37
"2011","Newcastle upon Tyne 018","E02001725","Total",4536,1168,411,757,20,1362,927,435,1936,1827,3,85,21,50
"2011","Newcastle upon Tyne 019","E02001726","Total",4687,2710,1154,1556,17,1290,1127,163,607,479,0,74,54,63
"2011","Newcastle upon Tyne 020","E02001727","Total",3877,2378,1141,1237,27,1098,938,160,324,273,2,41,8,50
"2011","Newcastle upon Tyne 021","E02001728","Total",4248,2705,1137,1568,8,987,849,138,488,429,13,41,5,60
"2011","Newcastle upon Tyne 022","E02001729","Total",4145,1227,609,618,14,1416,686,730,1430,1366,3,41,20,58
"2011","Newcastle upon Tyne 023","E02001730","Total",4835,1060,443,617,16,1788,1486,302,1889,1803,6,64,16,82
"2011","Newcastle upon Tyne 024","E02001731","Total",5587,873,339,534,25,2520,1187,1333,2089,1832,13,51,193,80
"2011","Newcastle upon Tyne 025","E02001732","Total",2193,1058,468,590,5,859,675,184,249,223,0,16,10,22
"2011","Newcastle upon Tyne 026","E02001733","Total",5675,1784,737,1047,7,2871,2523,348,945,886,0,47,12,68
"2011","Newcastle upon Tyne 027","E02001734","Total",3233,1391,614,777,10,1331,819,512,446,411,2,24,9,55
"2011","Newcastle upon Tyne 028","E02001735","Total",2884,696,250,446,2,1960,1824,136,192,174,2,16,0,34
"2011","Newcastle upon Tyne 029","E02001736","Total",4959,1322,559,763,21,2241,1758,483,1264,1176,6,55,27,111
"2011","Newcastle upon Tyne 030","E02001737","Total",2968,644,272,372,29,2032,1666,366,171,144,0,15,12,92
"2011","Newcastle upon Tyne 031","E02006893","Total",4739,3886,2098,1788,7,510,348,162,290,236,0,50,4,46
"2011","North Tyneside 001","E02001738","Total",2471,2306,1427,879,2,27,15,12,114,95,0,19,0,22
"2011","North Tyneside 002","E02001739","Total",3355,2034,772,1262,35,1034,774,260,236,212,0,19,5,16
"2011","North Tyneside 003","E02001740","Total",2294,2035,958,1077,5,62,52,10,174,155,2,15,2,18
"2011","North Tyneside 004","E02001741","Total",3283,2604,1423,1181,2,367,319,48,277,208,17,37,15,33
"2011","North Tyneside 005","E02001742","Total",2604,2183,1025,1158,17,172,48,124,221,199,2,17,3,11
"2011","North Tyneside 006","E02001743","Total",3195,2262,902,1360,26,200,87,113,672,612,7,45,8,35
"2011","North Tyneside 007","E02001744","Total",2877,2012,842,1170,8,568,453,115,260,234,2,22,2,29
"2011","North Tyneside 008","E02001745","Total",2786,1854,662,1192,6,691,601,90,219,176,0,37,6,16
"2011","North Tyneside 009","E02001746","Total",3598,2528,1086,1442,8,531,480,51,497,462,0,34,1,34
"2011","North Tyneside 010","E02001747","Total",2880,2441,1425,1016,2,197,185,12,214,181,0,26,7,26
"2011","North Tyneside 011","E02001748","Total",3253,2039,644,1395,22,792,732,60,370,331,3,30,6,30
"2011","North Tyneside 012","E02001749","Total",2772,1933,760,1173,9,576,348,228,233,209,1,22,1,21
"2011","North Tyneside 013","E02001750","Total",2841,2330,1198,1132,6,288,219,69,187,159,3,23,2,30
"2011","North Tyneside 014","E02001751","Total",2716,1825,825,1000,7,660,484,176,198,168,0,30,0,26
"2011","North Tyneside 015","E02001752","Total",2789,1521,642,879,5,988,906,82,253,230,0,23,0,22
"2011","North Tyneside 016","E02001753","Total",3230,1986,1003,983,11,551,175,376,624,568,10,41,5,58
"2011","North Tyneside 017","E02001754","Total",2849,2147,1008,1139,13,138,66,72,531,475,8,47,1,20
"2011","North Tyneside 018","E02001755","Total",3500,2596,1108,1488,4,515,421,94,363,322,2,37,2,22
"2011","North Tyneside 019","E02001756","Total",4391,2072,682,1390,21,1831,1429,402,440,407,1,28,4,27
"2011","North Tyneside 020","E02001757","Total",2753,1998,1044,954,2,524,461,63,209,179,3,24,3,20
"2011","North Tyneside 021","E02001758","Total",2450,1719,676,1043,39,523,500,23,152,125,1,24,2,17
"2011","North Tyneside 022","E02001759","Total",3261,1941,770,1171,10,419,148,271,857,794,1,59,3,34
"2011","North Tyneside 023","E02001760","Total",3471,1358,549,809,9,1477,1223,254,580,540,1,32,7,47
"2011","North Tyneside 024","E02001761","Total",2448,1628,738,890,7,612,550,62,178,150,0,27,1,23
"2011","North Tyneside 025","E02001762","Total",2471,1997,846,1151,31,226,217,9,202,163,0,39,0,15
"2011","North Tyneside 026","E02001763","Total",2882,1385,498,887,6,1205,889,316,254,225,0,26,3,32
"2011","North Tyneside 027","E02001764","Total",3883,1346,389,957,30,1693,874,819,785,729,1,50,5,29
"2011","North Tyneside 028","E02001765","Total",3312,1404,404,1000,21,1297,894,403,564,532,3,27,2,26
"2011","North Tyneside 029","E02001766","Total",3295,1717,579,1138,3,626,438,188,918,856,1,58,3,31
"2011","North Tyneside 030","E02001767","Total",3385,1935,726,1209,7,887,622,265,518,450,8,51,9,38
"2011","South Tyneside 001","E02001768","Total",3812,2256,910,1346,69,721,515,206,735,653,4,74,4,31
"2011","South Tyneside 002","E02001769","Total",3973,1322,616,706,23,1778,1122,656,798,737,5,45,11,52
"2011","South Tyneside 003","E02001770","Total",3035,2102,917,1185,27,240,45,195,633,566,5,57,5,33
"2011","South Tyneside 004","E02001771","Total",2806,1566,812,754,46,1037,905,132,131,117,2,11,1,26
"2011","South Tyneside 005","E02001772","Total",2467,1608,764,844,12,451,332,119,381,336,1,40,4,15
"2011","South Tyneside 006","E02001773","Total",2381,2038,1155,883,12,182,75,107,117,100,0,17,0,32
"2011","South Tyneside 007","E02001774","Total",2559,1214,470,744,7,998,925,73,317,296,0,19,2,23
"2011","South Tyneside 008","E02001775","Total",2450,1202,456,746,3,1081,721,360,138,126,0,9,3,26
"2011","South Tyneside 009","E02001776","Total",3729,1938,718,1220,8,1310,832,478,437,385,3,43,6,36
"2011","South Tyneside 010","E02001777","Total",2897,1848,620,1228,7,672,622,50,355,326,2,24,3,15
"2011","South Tyneside 011","E02001778","Total",2939,1447,544,903,5,738,559,179,722,667,8,41,6,27
"2011","South Tyneside 012","E02001779","Total",2519,1119,492,627,10,1156,879,277,220,193,4,15,8,14
"2011","South Tyneside 013","E02001780","Total",2318,1231,632,599,9,959,550,409,104,87,0,13,4,15
"2011","South Tyneside 014","E02001781","Total",2567,1110,463,647,1,1305,1254,51,133,117,0,13,3,18
"2011","South Tyneside 015","E02001782","Total",3835,2106,926,1180,4,1508,1476,32,182,150,0,28,4,35
"2011","South Tyneside 016","E02001783","Total",2980,1310,502,808,2,1446,1303,143,197,178,0,17,2,25
"2011","South Tyneside 017","E02001784","Total",2970,1512,625,887,7,1297,1182,115,132,109,0,22,1,22
"2011","South Tyneside 018","E02001785","Total",3555,2253,1086,1167,18,1069,865,204,187,161,0,20,6,28
"2011","South Tyneside 019","E02001786","Total",3178,1739,735,1004,11,1248,1193,55,163,136,1,26,0,17
"2011","South Tyneside 020","E02001787","Total",2457,1495,662,833,9,799,679,120,146,131,1,11,3,8
"2011","South Tyneside 021","E02001788","Total",2636,1622,622,1000,3,737,523,214,247,230,2,15,0,27
"2011","South Tyneside 022","E02001789","Total",2471,2303,1288,1015,2,30,21,9,118,100,0,17,1,18
"2011","South Tyneside 023","E02001790","Total",2633,1992,988,1004,2,442,389,53,165,139,3,20,3,32
"2011","Sunderland 001","E02001791","Total",2427,2196,1158,1038,10,45,12,33,153,144,1,8,0,23
"2011","Sunderland 002","E02001792","Total",3048,2711,1472,1239,7,78,30,48,232,192,1,34,5,20
"2011","Sunderland 003","E02001793","Total",3822,1508,542,966,5,1912,1046,866,384,346,3,15,20,13
"2011","Sunderland 004","E02001794","Total",3732,1717,788,929,4,1700,1024,676,289,250,1,20,18,22
"2011","Sunderland 005","E02001795","Total",3577,1711,799,912,2,1183,517,666,656,598,4,49,5,25
"2011","Sunderland 006","E02001796","Total",4426,2725,1345,1380,23,683,271,412,940,864,7,54,15,55
"2011","Sunderland 007","E02001797","Total",2486,1999,928,1071,6,299,170,129,164,144,0,16,4,18
"2011","Sunderland 008","E02001798","Total",3445,1896,785,1111,4,1256,693,563,259,205,7,32,15,30
"2011","Sunderland 009","E02001799","Total",4424,2033,789,1244,4,1780,1077,703,582,542,2,29,9,25
"2011","Sunderland 010","E02001800","Total",3014,1798,654,1144,12,947,530,417,241,212,0,23,6,16
"2011","Sunderland 011","E02001801","Total",2515,1451,594,857,9,247,67,180,779,706,6,50,17,29
"2011","Sunderland 012","E02001802","Total",2638,1068,403,665,2,1308,681,627,249,219,0,17,13,11
"2011","Sunderland 013","E02001803","Total",4188,1187,530,657,16,1136,465,671,1809,1720,7,47,35,40
"2011","Sunderland 014","E02001804","Total",2706,1624,658,966,3,839,521,318,225,191,4,24,6,15
"2011","Sunderland 015","E02001805","Total",2501,1952,1085,867,10,178,57,121,342,307,6,26,3,19
"2011","Sunderland 016","E02001806","Total",4143,1432,637,795,7,1451,523,928,1223,1160,3,45,15,30
"2011","Sunderland 017","E02001807","Total",3027,1791,657,1134,9,907,534,373,304,281,2,19,2,16
"2011","Sunderland 018","E02001808","Total",2468,1797,851,946,3,64,27,37,574,508,8,52,6,30
"2011","Sunderland 019","E02001809","Total",2881,1954,926,1028,2,694,390,304,208,181,1,21,5,23
"2011","Sunderland 020","E02001810","Total",3699,2401,818,1583,29,969,577,392,287,248,3,28,8,13
"2011","Sunderland 021","E02001811","Total",4087,2095,992,1103,6,1698,959,739,258,209,1,30,18,30
"2011","Sunderland 022","E02001812","Total",4354,3815,2142,1673,7,70,18,52,425,380,4,35,6,37
"2011","Sunderland 023","E02001813","Total",4318,1693,655,1038,12,2261,1044,1217,310,262,1,35,12,42
"2011","Sunderland 024","E02001814","Total",2762,1683,753,930,1,755,397,358,297,276,0,20,1,26
"2011","Sunderland 025","E02001815","Total",4244,3154,1328,1826,12,808,415,393,239,210,1,24,4,31
"2011","Sunderland 026","E02001816","Total",3357,1575,697,878,9,1466,728,738,282,244,1,28,9,25
"2011","Sunderland 027","E02001817","Total",2714,1517,642,875,28,855,373,482,290,255,2,23,10,24
"2011","Sunderland 028","E02001818","Total",3530,2126,832,1294,5,1028,609,419,345,295,5,32,13,26
"2011","Sunderland 029","E02001819","Total",3054,2500,1339,1161,40,277,129,148,218,181,3,27,7,19
"2011","Sunderland 030","E02001820","Total",3618,2313,985,1328,0,1016,551,465,261,219,1,32,9,28
"2011","Sunderland 031","E02001821","Total",2453,1790,674,1116,22,494,222,272,136,107,1,23,5,11
"2011","Sunderland 032","E02001822","Total",3165,2370,1007,1363,2,379,195,184,389,346,2,37,4,25
"2011","Sunderland 033","E02001823","Total",3064,1915,802,1113,6,829,443,386,294,265,1,26,2,20
"2011","Sunderland 034","E02001824","Total",3722,2457,1289,1168,11,939,468,471,289,259,1,22,7,26
"2011","Sunderland 035","E02001825","Total",3232,2084,1098,986,13,794,395,399,311,269,1,33,8,30
"2011","Sunderland 036","E02001826","Total",2917,1528,765,763,11,1054,567,487,308,282,0,17,9,16
"2011","Blackburn with Darwen 001","E02002615","Total",3952,3022,1579,1443,5,477,168,309,393,344,2,43,4,55
"2011","Blackburn with Darwen 002","E02002616","Total",2941,2552,1332,1220,7,24,2,22,320,288,0,28,4,38
"2011","Blackburn with Darwen 003","E02002617","Total",2668,1539,945,594,15,580,98,482,494,431,0,36,27,40
"2011","Blackburn with Darwen 004","E02002618","Total",2143,1451,938,513,4,331,85,246,302,263,0,29,10,55
"2011","Blackburn with Darwen 005","E02002619","Total",3057,1775,961,814,35,491,124,367,698,654,0,30,14,58
"2011","Blackburn with Darwen 006","E02002620","Total",3225,1183,729,454,20,1332,285,1047,597,536,7,27,27,93
"2011","Blackburn with Darwen 007","E02002621","Total",2610,1324,988,336,33,816,192,624,371,339,2,22,8,66
"2011","Blackburn with Darwen 008","E02002622","Total",3903,1580,714,866,3,1735,757,978,504,459,3,30,12,81
"2011","Blackburn with Darwen 009","E02002623","Total",4559,2344,943,1401,52,933,221,712,1160,1055,32,57,16,70
"2011","Blackburn with Darwen 010","E02002624","Total",3346,2961,1577,1384,7,103,21,82,245,221,3,19,2,30
"2011","Blackburn with Darwen 011","E02002625","Total",3935,2112,775,1337,21,1208,468,740,543,484,9,40,10,51
"2011","Blackburn with Darwen 012","E02002626","Total",3091,1987,984,1003,8,739,327,412,299,255,0,35,9,58
"2011","Blackburn with Darwen 013","E02002627","Total",2969,2566,813,1753,4,17,4,13,366,319,2,44,1,16
"2011","Blackburn with Darwen 014","E02002628","Total",3132,2016,962,1054,18,449,152,297,607,547,2,42,16,42
"2011","Blackburn with Darwen 015","E02002629","Total",2588,1461,709,752,12,486,179,307,599,564,1,27,7,30
"2011","Blackburn with Darwen 016","E02002630","Total",2661,1597,681,916,18,279,67,212,731,672,4,46,9,36
"2011","Blackburn with Darwen 017","E02002631","Total",3925,2967,1246,1721,28,357,71,286,525,479,2,40,4,48
"2011","Blackburn with Darwen 018","E02002632","Total",2648,2356,1163,1193,0,34,7,27,239,203,3,23,10,19
"2011","Blackpool 001","E02002633","Total",3595,2950,1609,1341,9,22,11,11,580,515,3,61,1,34
"2011","Blackpool 002","E02002634","Total",4040,2681,1410,1271,29,823,652,171,449,404,1,40,4,58
"2011","Blackpool 003","E02002635","Total",3683,2815,1584,1231,5,59,16,43,770,698,5,60,7,34
"2011","Blackpool 004","E02002636","Total",3738,2600,1100,1500,32,514,352,162,557,506,1,49,1,35
"2011","Blackpool 005","E02002637","Total",2673,2147,1067,1080,6,57,46,11,442,405,0,36,1,21
"2011","Blackpool 006","E02002638","Total",2907,1025,507,518,12,192,10,182,1643,1591,4,40,8,35
"2011","Blackpool 007","E02002639","Total",2745,907,409,498,18,1471,1198,273,285,252,1,30,2,64
"2011","Blackpool 008","E02002640","Total",3493,1251,512,739,31,1021,707,314,1138,1095,4,33,6,52
"2011","Blackpool 009","E02002641","Total",3570,2541,1123,1418,12,85,44,41,903,811,7,76,9,29
"2011","Blackpool 010","E02002642","Total",3382,1041,548,493,8,363,182,181,1939,1874,8,45,12,31
"2011","Blackpool 011","E02002643","Total",3358,1847,804,1043,13,257,162,95,1209,1132,2,68,7,32
"2011","Blackpool 012","E02002644","Total",3512,2725,1244,1481,5,36,27,9,713,618,3,92,0,33
"2011","Blackpool 013","E02002645","Total",2581,758,381,377,6,127,65,62,1662,1616,6,31,9,28
"2011","Blackpool 014","E02002646","Total",3352,2013,993,1020,9,829,690,139,455,399,1,52,3,46
"2011","Blackpool 015","E02002647","Total",3655,2264,1037,1227,13,244,99,145,1098,981,3,104,10,36
"2011","Blackpool 016","E02002648","Total",3267,2140,959,1181,8,340,259,81,741,672,2,64,3,38
"2011","Blackpool 017","E02002649","Total",3675,2405,1182,1223,3,76,5,71,1156,1086,3,62,5,35
"2011","Blackpool 018","E02002650","Total",3610,2825,1460,1365,10,209,96,113,535,465,7,60,3,31
"2011","Blackpool 019","E02002651","Total",3531,2715,1389,1326,10,274,202,72,495,429,1,59,6,37
"2011","Cheshire East 022","E02003811","Total",2433,2056,1226,830,5,165,24,141,159,144,3,10,2,48
"2011","Cheshire East 023","E02003812","Total",2419,2027,1118,909,5,146,29,117,205,187,2,13,3,36
"2011","Cheshire East 024","E02003813","Total",2710,2098,1026,1072,19,287,53,234,287,266,1,17,3,19
"2011","Cheshire East 025","E02003814","Total",2961,2292,793,1499,15,335,115,220,295,275,3,17,0,24
"2011","Cheshire East 026","E02003815","Total",2897,1762,835,927,8,859,171,688,233,212,1,19,1,35
"2011","Cheshire East 027","E02003816","Total",3192,2106,1072,1034,19,463,71,392,563,504,13,41,5,41
"2011","Cheshire East 028","E02003817","Total",3005,2591,1404,1187,8,174,25,149,206,188,3,14,1,26
"2011","Cheshire East 029","E02003818","Total",2467,2207,1166,1041,13,13,0,13,207,187,0,17,3,27
"2011","Cheshire East 030","E02003819","Total",2540,2104,1200,904,16,168,29,139,235,218,2,13,2,17
"2011","Cheshire East 031","E02003820","Total",2770,2280,896,1384,4,99,13,86,374,342,2,27,3,13
"2011","Cheshire East 032","E02003821","Total",2530,1764,982,782,20,466,99,367,247,215,0,23,9,33
"2011","Cheshire East 033","E02003822","Total",4584,3762,2042,1720,14,355,53,302,401,352,6,32,11,52
"2011","Cheshire East 040","E02003823","Total",2967,2318,1340,978,11,363,72,291,242,220,1,17,4,33
"2011","Cheshire East 042","E02003824","Total",2216,1724,894,830,5,221,43,178,242,220,1,20,1,24
"2011","Cheshire East 034","E02003825","Total",2618,2307,616,1691,7,61,20,41,232,210,2,16,4,11
"2011","Cheshire East 035","E02003826","Total",2998,1829,763,1066,3,765,350,415,367,334,2,24,7,34
"2011","Cheshire East 036","E02003827","Total",3882,1951,967,984,18,971,326,645,894,848,6,30,10,48
"2011","Cheshire East 037","E02003828","Total",2804,1517,686,831,27,899,351,548,339,320,0,14,5,22
"2011","Cheshire East 038","E02003829","Total",2549,2103,1182,921,5,160,31,129,251,228,0,21,2,30
"2011","Cheshire East 039","E02003830","Total",3213,1780,716,1064,12,513,142,371,873,831,4,32,6,35
"2011","Cheshire East 041","E02003831","Total",3660,3070,1522,1548,13,146,25,121,383,340,5,20,18,48
"2011","Cheshire East 043","E02003832","Total",2488,1405,644,761,9,225,46,179,830,798,5,24,3,19
"2011","Cheshire East 044","E02003833","Total",2640,2036,916,1120,5,384,154,230,190,161,2,24,3,25
"2011","Cheshire East 045","E02003834","Total",2786,1621,657,964,5,492,193,299,639,611,1,25,2,29
"2011","Cheshire East 046","E02003835","Total",3303,3107,1746,1361,4,18,7,11,157,134,1,19,3,17
"2011","Cheshire East 047","E02003836","Total",3419,2332,1372,960,32,550,110,440,470,423,2,38,7,35
"2011","Cheshire East 049","E02003837","Total",4612,3759,1662,2097,14,177,47,130,605,519,30,45,11,57
"2011","Cheshire East 048","E02003838","Total",2764,2397,1354,1043,4,91,15,76,248,216,0,26,6,24
"2011","Cheshire East 050","E02003839","Total",3291,2242,1233,1009,47,432,108,324,533,488,4,36,5,37
"2011","Cheshire East 051","E02003840","Total",4140,3206,1817,1389,17,304,69,235,522,453,24,28,17,91
"2011","Cheshire East 001","E02003853","Total",2472,2074,1116,958,28,118,24,94,224,205,2,12,5,28
"2011","Cheshire East 002","E02003854","Total",2697,2251,1184,1067,4,282,44,238,141,119,3,17,2,19
"2011","Cheshire East 003","E02003855","Total",2811,2528,1502,1026,3,59,12,47,196,172,3,20,1,25
"2011","Cheshire East 004","E02003856","Total",4778,2888,1328,1560,73,1182,59,1123,593,541,7,39,6,42
"2011","Cheshire East 005","E02003857","Total",2735,2048,877,1171,25,303,64,239,337,317,1,18,1,22
"2011","Cheshire East 006","E02003858","Total",2911,2276,1247,1029,5,136,15,121,456,431,5,16,4,38
"2011","Cheshire East 007","E02003859","Total",4801,3633,2050,1583,27,273,62,211,757,685,16,38,18,111
"2011","Cheshire East 008","E02003860","Total",2889,2591,1361,1230,8,45,6,39,214,197,2,13,2,31
"2011","Cheshire East 009","E02003861","Total",2896,1893,962,931,14,648,101,547,305,269,10,25,1,36
"2011","Cheshire East 011","E02003862","Total",2093,1810,1117,693,6,73,20,53,164,150,4,5,5,40
"2011","Cheshire East 010","E02003863","Total",3014,2359,1316,1043,8,240,27,213,372,346,5,19,2,35
"2011","Cheshire East 012","E02003864","Total",3624,2824,1635,1189,3,250,50,200,489,463,7,16,3,58
"2011","Cheshire East 013","E02003865","Total",3437,2518,1204,1314,3,297,76,221,587,548,4,25,10,32
"2011","Cheshire East 014","E02003866","Total",2402,2181,1103,1078,6,39,0,39,162,145,2,12,3,14
"2011","Cheshire East 015","E02003867","Total",3140,2392,1027,1365,13,365,92,273,341,319,0,21,1,29
"2011","Cheshire East 016","E02003868","Total",3901,2449,1081,1368,18,889,215,674,488,449,2,33,4,57
"2011","Cheshire East 017","E02003869","Total",2992,2503,1252,1251,35,152,39,113,282,252,4,22,4,20
"2011","Cheshire East 018","E02003870","Total",5079,3163,1248,1915,32,377,26,351,1471,1377,5,70,19,36
"2011","Cheshire East 019","E02003871","Total",3058,1924,875,1049,17,871,257,614,197,167,1,23,6,49
"2011","Cheshire East 020","E02003872","Total",4188,3343,1997,1346,41,301,76,225,425,366,13,33,13,78
"2011","Cheshire East 021","E02003873","Total",2665,1365,517,848,26,939,229,710,308,282,1,21,4,27
"2011","Cheshire West and Chester 022","E02003794","Total",3531,2941,1425,1516,19,208,39,169,327,289,11,20,7,36
"2011","Cheshire West and Chester 025","E02003795","Total",2211,1724,956,768,3,165,59,106,295,153,92,8,42,24
"2011","Cheshire West and Chester 027","E02003796","Total",3254,2235,1269,966,11,747,289,458,220,188,6,18,8,41
"2011","Cheshire West and Chester 028","E02003797","Total",3990,3093,1576,1517,25,148,18,130,684,623,15,29,17,40
"2011","Cheshire West and Chester 029","E02003798","Total",2488,1244,467,777,5,1025,348,677,179,152,0,20,7,35
"2011","Cheshire West and Chester 031","E02003799","Total",3103,1613,752,861,30,1224,395,829,198,160,4,29,5,38
"2011","Cheshire West and Chester 030","E02003800","Total",2603,2213,1271,942,21,138,37,101,205,183,1,18,3,26
"2011","Cheshire West and Chester 032","E02003801","Total",2888,2349,1189,1160,6,265,87,178,235,213,3,18,1,33
"2011","Cheshire West and Chester 033","E02003802","Total",4274,1561,668,893,95,1029,212,817,1538,1467,3,53,15,51
"2011","Cheshire West and Chester 034","E02003803","Total",3869,1501,758,743,94,481,62,419,1725,1605,6,59,55,68
"2011","Cheshire West and Chester 036","E02003804","Total",3217,2070,868,1202,21,341,70,271,749,698,2,44,5,36
"2011","Cheshire West and Chester 039","E02003805","Total",2535,2161,1232,929,4,122,31,91,227,213,5,7,2,21
"2011","Cheshire West and Chester 041","E02003806","Total",2547,2195,1191,1004,30,61,21,40,242,213,4,23,2,19
"2011","Cheshire West and Chester 043","E02003807","Total",3832,2930,1758,1172,5,242,49,193,612,575,7,25,5,43
"2011","Cheshire West and Chester 044","E02003808","Total",2776,1620,589,1031,16,774,286,488,327,298,2,25,2,39
"2011","Cheshire West and Chester 046","E02003809","Total",3061,2033,1165,868,47,229,48,181,624,568,24,23,9,128
"2011","Cheshire West and Chester 047","E02003810","Total",3445,2540,1421,1119,44,307,72,235,494,439,15,34,6,60
"2011","Cheshire West and Chester 001","E02003841","Total",3462,2369,1340,1029,11,672,393,279,367,336,4,24,3,43
"2011","Cheshire West and Chester 004","E02003842","Total",2367,2040,1245,795,8,92,50,42,204,188,5,7,4,23
"2011","Cheshire West and Chester 005","E02003843","Total",2612,1821,860,961,31,504,437,67,230,211,2,13,4,26
"2011","Cheshire West and Chester 006","E02003844","Total",2948,2459,1313,1146,7,225,174,51,228,205,1,19,3,29
"2011","Cheshire West and Chester 007","E02003845","Total",3846,1661,557,1104,49,1222,931,291,852,811,7,32,2,62
"2011","Cheshire West and Chester 008","E02003846","Total",2928,1422,577,845,7,1184,1053,131,269,236,1,29,3,46
"2011","Cheshire West and Chester 009","E02003847","Total",3844,3536,1545,1991,20,21,6,15,235,210,0,22,3,32
"2011","Cheshire West and Chester 010","E02003848","Total",2135,1336,579,757,4,621,612,9,140,120,2,17,1,34
"2011","Cheshire West and Chester 011","E02003849","Total",3003,1346,471,875,35,1320,1155,165,248,220,4,18,6,54
"2011","Cheshire West and Chester 013","E02003850","Total",2265,1828,848,980,2,292,286,6,116,91,1,24,0,27
"2011","Cheshire West and Chester 014","E02003851","Total",2375,2174,1039,1135,13,39,32,7,137,122,0,14,1,12
"2011","Cheshire West and Chester 016","E02003852","Total",2792,2587,1192,1395,13,10,4,6,172,151,2,15,4,10
"2011","Cheshire West and Chester 002","E02003874","Total",4025,3106,1726,1380,34,412,170,242,423,371,5,38,9,50
"2011","Cheshire West and Chester 003","E02003875","Total",2681,2286,1254,1032,17,170,63,107,173,150,4,9,10,35
"2011","Cheshire West and Chester 012","E02003876","Total",2393,1836,858,978,8,283,166,117,238,210,4,21,3,28
"2011","Cheshire West and Chester 015","E02003877","Total",3884,3292,1820,1472,21,196,74,122,342,299,3,35,5,33
"2011","Cheshire West and Chester 017","E02003878","Total",3299,2712,1424,1288,11,284,147,137,260,218,5,25,12,32
"2011","Cheshire West and Chester 018","E02003879","Total",2800,1695,680,1015,28,425,123,302,630,592,4,30,4,22
"2011","Cheshire West and Chester 019","E02003880","Total",2755,1956,978,978,13,548,307,241,205,182,3,20,0,33
"2011","Cheshire West and Chester 020","E02003881","Total",2730,1755,708,1047,31,392,152,240,526,489,5,30,2,26
"2011","Cheshire West and Chester 021","E02003882","Total",3989,2483,1041,1442,55,1019,538,481,377,335,11,29,2,55
"2011","Cheshire West and Chester 023","E02003883","Total",4031,3411,1438,1973,53,107,44,63,437,408,4,18,7,23
"2011","Cheshire West and Chester 024","E02003884","Total",3318,2801,1570,1231,18,206,93,113,253,217,7,28,1,40
"2011","Cheshire West and Chester 026","E02003885","Total",2408,1974,1003,971,7,184,73,111,210,184,2,20,4,33
"2011","Cheshire West and Chester 035","E02003886","Total",2599,1752,667,1085,7,527,290,237,285,269,1,15,0,28
"2011","Cheshire West and Chester 037","E02003887","Total",2496,1971,731,1240,23,253,120,133,229,206,2,19,2,20
"2011","Cheshire West and Chester 038","E02003888","Total",2627,1658,658,1000,17,606,333,273,325,290,10,22,3,21
"2011","Cheshire West and Chester 040","E02003889","Total",2297,1156,544,612,36,917,431,486,152,134,0,14,4,36
"2011","Cheshire West and Chester 042","E02003890","Total",2454,1746,771,975,8,375,39,336,310,280,3,25,2,15
"2011","Cheshire West and Chester 045","E02003891","Total",2455,1913,1137,776,25,196,63,133,280,249,11,15,5,41
"2011","Halton 001","E02002574","Total",2986,2660,1308,1352,1,60,9,51,245,228,1,15,1,20
"2011","Halton 002","E02002575","Total",3732,3332,1117,2215,7,83,4,79,292,272,0,20,0,18
"2011","Halton 003","E02002576","Total",3233,2166,997,1169,6,627,139,488,395,358,1,33,3,39
"2011","Halton 004","E02002577","Total",3287,1507,686,821,10,1497,397,1100,199,179,1,16,3,74
"2011","Halton 005","E02002578","Total",3207,2166,1012,1154,3,731,243,488,270,232,3,29,6,37
"2011","Halton 006","E02002579","Total",3193,1943,863,1080,6,940,311,629,267,242,0,21,4,37
"2011","Halton 007","E02002580","Total",3426,1439,603,836,15,1163,372,791,766,708,4,46,8,43
"2011","Halton 008","E02002581","Total",3108,2465,1223,1242,12,299,95,204,296,272,0,20,4,36
"2011","Halton 009","E02002582","Total",3103,2797,906,1891,46,88,5,83,161,147,0,12,2,11
"2011","Halton 010","E02002583","Total",3093,928,441,487,62,1951,142,1809,125,98,0,16,11,27
"2011","Halton 011","E02002584","Total",3089,2221,993,1228,11,577,130,447,249,216,1,29,3,31
"2011","Halton 012","E02002585","Total",4897,2886,1180,1706,8,905,124,781,1052,998,2,45,7,46
"2011","Halton 013","E02002586","Total",4060,1767,732,1035,24,1943,329,1614,267,240,0,21,6,59
"2011","Halton 014","E02002587","Total",2919,1508,506,1002,82,1057,86,971,249,231,1,12,5,23
"2011","Halton 015","E02002588","Total",3245,1465,561,904,5,1505,116,1389,250,215,0,28,7,20
"2011","Halton 016","E02002589","Total",2734,2546,1308,1238,24,15,0,15,129,116,0,13,0,20
"2011","Warrington 001","E02002590","Total",2525,2185,1191,994,4,137,70,67,178,152,2,19,5,21
"2011","Warrington 002","E02002591","Total",2772,2185,1155,1030,8,335,199,136,227,201,2,21,3,17
"2011","Warrington 003","E02002592","Total",2557,2125,1037,1088,8,209,129,80,188,165,0,20,3,27
"2011","Warrington 004","E02002593","Total",2367,1602,687,915,37,484,75,409,226,203,0,23,0,18
"2011","Warrington 005","E02002594","Total",2472,1377,447,930,21,839,133,706,221,194,0,22,5,14
"2011","Warrington 006","E02002595","Total",3409,1555,589,966,15,1581,1216,365,229,195,0,29,5,29
"2011","Warrington 007","E02002596","Total",3538,2789,1273,1516,19,400,53,347,300,266,0,28,6,30
"2011","Warrington 008","E02002597","Total",3837,1645,695,950,14,1901,843,1058,234,192,1,32,9,43
"2011","Warrington 009","E02002598","Total",2892,2347,522,1825,90,104,7,97,336,311,2,21,2,15
"2011","Warrington 010","E02002599","Total",4129,3232,976,2256,79,423,51,372,362,341,1,17,3,33
"2011","Warrington 011","E02002600","Total",4104,2591,1088,1503,33,889,433,456,545,489,4,48,4,46
"2011","Warrington 012","E02002601","Total",3343,2858,1448,1410,4,226,74,152,229,192,0,37,0,26
"2011","Warrington 013","E02002602","Total",3166,1447,500,947,9,1058,663,395,609,566,3,35,5,43
"2011","Warrington 014","E02002603","Total",2862,2570,1246,1324,2,129,76,53,140,120,0,20,0,21
"2011","Warrington 015","E02002604","Total",3141,2774,1322,1452,23,136,63,73,189,171,0,15,3,19
"2011","Warrington 016","E02002605","Total",3742,2859,1067,1792,47,483,76,407,335,298,3,28,6,18
"2011","Warrington 017","E02002606","Total",4930,2474,918,1556,63,822,340,482,1541,1456,5,70,10,30
"2011","Warrington 018","E02002607","Total",4868,2669,1261,1408,32,977,454,523,1125,1053,5,57,10,65
"2011","Warrington 019","E02002608","Total",3526,3183,1732,1451,9,77,43,34,228,195,0,31,2,29
"2011","Warrington 020","E02002609","Total",3731,1915,764,1151,10,1114,666,448,656,618,2,31,5,36
"2011","Warrington 021","E02002610","Total",5171,4076,1992,2084,45,386,235,151,622,578,4,37,3,42
"2011","Warrington 022","E02002611","Total",3253,2865,1458,1407,22,165,22,143,174,158,0,14,2,27
"2011","Warrington 023","E02002612","Total",4009,3103,1498,1605,40,410,207,203,414,361,8,44,1,42
"2011","Warrington 024","E02002613","Total",2402,2179,1070,1109,2,24,15,9,174,148,9,13,4,23
"2011","Warrington 025","E02002614","Total",2394,2310,1270,1040,1,9,4,5,67,60,1,6,0,7
"2011","Allerdale 001","E02003965","Total",4705,3448,2008,1440,5,722,92,630,452,403,3,43,3,78
"2011","Allerdale 002","E02003966","Total",2945,2384,1581,803,18,134,20,114,336,277,14,40,5,73
"2011","Allerdale 003","E02003967","Total",3580,2545,1490,1055,14,540,55,485,413,357,5,48,3,68
"2011","Allerdale 004","E02003968","Total",3755,2795,1555,1240,11,562,51,511,346,302,3,38,3,41
"2011","Allerdale 005","E02003969","Total",2898,1454,771,683,2,1201,150,1051,193,163,2,26,2,48
"2011","Allerdale 006","E02003970","Total",3454,2515,1432,1083,20,396,38,358,469,424,5,33,7,54
"2011","Allerdale 007","E02003971","Total",3513,2665,1635,1030,41,379,68,311,368,310,11,35,12,60
"2011","Allerdale 008","E02003972","Total",4141,2938,1447,1491,11,709,108,601,441,402,1,27,11,42
"2011","Allerdale 009","E02003973","Total",4132,2036,1023,1013,6,1560,232,1328,454,400,5,45,4,76
"2011","Allerdale 010","E02003974","Total",3461,2133,1145,988,45,1095,184,911,141,111,1,23,6,47
"2011","Allerdale 011","E02003975","Total",2749,2280,1221,1059,1,247,33,214,187,172,0,12,3,34
"2011","Allerdale 012","E02003976","Total",3012,2024,1378,646,26,543,92,451,342,274,18,27,23,77
"2011","Barrow-in-Furness 001","E02003977","Total",2680,2312,1103,1209,4,53,35,18,274,235,5,33,1,37
"2011","Barrow-in-Furness 002","E02003978","Total",2618,2131,1045,1086,3,215,179,36,238,212,2,22,2,31
"2011","Barrow-in-Furness 003","E02003979","Total",3350,3127,1980,1147,4,17,9,8,175,126,16,19,14,27
"2011","Barrow-in-Furness 004","E02003980","Total",3189,1673,709,964,4,1056,897,159,400,362,7,25,6,56
"2011","Barrow-in-Furness 005","E02003981","Total",2990,2462,1050,1412,3,76,43,33,414,380,1,32,1,35
"2011","Barrow-in-Furness 006","E02003982","Total",3224,2739,1358,1381,3,283,271,12,172,147,1,22,2,27
"2011","Barrow-in-Furness 007","E02003983","Total",3426,2190,925,1265,7,675,564,111,513,456,5,50,2,41
"2011","Barrow-in-Furness 008","E02003984","Total",3422,1702,830,872,5,402,116,286,1276,1188,8,60,20,37
"2011","Barrow-in-Furness 009","E02003985","Total",3088,2448,1307,1141,1,335,297,38,271,241,1,29,0,33
"2011","Barrow-in-Furness 010","E02003986","Total",3237,2154,1116,1038,2,342,293,49,709,658,3,40,8,30
"2011","Carlisle 001","E02003987","Total",2629,1890,1127,763,7,273,60,213,378,334,7,33,4,81
"2011","Carlisle 002","E02003988","Total",2948,1957,1115,842,9,482,75,407,441,373,25,30,13,59
"2011","Carlisle 003","E02003989","Total",3335,2706,1420,1286,43,211,28,183,347,305,4,34,4,28
"2011","Carlisle 004","E02003990","Total",4217,3483,1824,1659,107,214,31,183,385,349,4,25,7,28
"2011","Carlisle 005","E02003991","Total",3197,2824,1500,1324,13,112,14,98,216,188,2,24,2,32
"2011","Carlisle 006","E02003992","Total",4201,2190,1106,1084,72,576,63,513,1289,1208,5,50,26,74
"2011","Carlisle 007","E02003993","Total",3720,3058,1830,1228,6,173,19,154,415,366,18,26,5,68
"2011","Carlisle 008","E02003994","Total",3519,2066,988,1078,5,734,121,613,674,601,15,48,10,40
"2011","Carlisle 009","E02003995","Total",4475,2636,1184,1452,13,1473,290,1183,290,249,1,39,1,63
"2011","Carlisle 010","E02003996","Total",4756,2801,1127,1674,7,436,59,377,1457,1353,9,88,7,55
"2011","Carlisle 011","E02003997","Total",4280,2234,785,1449,8,1594,325,1269,379,333,2,41,3,65
"2011","Carlisle 012","E02003998","Total",3007,1808,849,959,26,926,173,753,201,172,0,24,5,46
"2011","Carlisle 013","E02003999","Total",4058,3346,1899,1447,16,190,25,165,442,390,12,31,9,64
"2011","Copeland 001","E02004000","Total",2309,1545,755,790,0,557,170,387,173,157,1,15,0,34
"2011","Copeland 002","E02004001","Total",2735,1587,788,799,56,705,297,408,329,295,9,19,6,58
"2011","Copeland 003","E02004002","Total",4325,3537,1661,1876,1,488,195,293,270,214,25,19,12,29
"2011","Copeland 004","E02004003","Total",5278,3636,1917,1719,12,1110,303,807,449,395,3,39,12,71
"2011","Copeland 005","E02004004","Total",3983,2395,1141,1254,4,1265,717,548,258,217,1,33,7,61
"2011","Copeland 006","E02004005","Total",3605,2491,1243,1248,4,767,324,443,305,257,0,42,6,38
"2011","Copeland 007","E02004006","Total",3926,3273,1929,1344,9,212,65,147,369,324,8,30,7,63
"2011","Copeland 008","E02004007","Total",4375,3207,1881,1326,10,564,101,463,512,456,4,46,6,82
"2011","Eden 001","E02004008","Total",2771,2009,1250,759,19,262,36,226,403,353,11,35,4,78
"2011","Eden 002","E02004009","Total",2493,1824,1108,716,14,121,25,96,440,401,10,24,5,94
"2011","Eden 003","E02004010","Total",3354,1831,877,954,41,816,112,704,605,533,17,49,6,61
"2011","Eden 004","E02004011","Total",4311,3400,2103,1297,51,309,53,256,495,422,15,53,5,56
"2011","Eden 005","E02004012","Total",2491,1702,1178,524,13,245,27,218,447,368,28,36,15,84
"2011","Eden 006","E02004013","Total",4319,3119,1955,1164,65,319,34,285,707,621,12,59,15,109
"2011","Eden 007","E02004014","Total",3304,2373,1577,796,8,249,20,229,588,518,10,54,6,86
"2011","South Lakeland 001","E02004015","Total",2924,1629,1174,455,16,620,260,360,578,506,23,35,14,81
"2011","South Lakeland 002","E02004016","Total",3738,2486,1553,933,32,489,329,160,656,586,22,45,3,75
"2011","South Lakeland 003","E02004017","Total",3865,2712,1449,1263,17,492,302,190,586,524,3,54,5,58
"2011","South Lakeland 004","E02004018","Total",3783,2112,1094,1018,21,800,560,240,785,718,6,52,9,65
"2011","South Lakeland 005","E02004019","Total",3397,2818,1672,1146,17,175,139,36,333,302,1,26,4,54
"2011","South Lakeland 006","E02004020","Total",3597,2978,1593,1385,17,247,105,142,325,285,4,33,3,30
"2011","South Lakeland 007","E02004021","Total",2404,1661,1119,542,12,161,77,84,498,442,19,22,15,72
"2011","South Lakeland 008","E02004022","Total",2493,1880,1268,612,10,184,98,86,369,295,22,39,13,50
"2011","South Lakeland 009","E02004023","Total",2661,1781,1199,582,22,266,210,56,502,415,30,51,6,90
"2011","South Lakeland 010","E02004024","Total",3107,2600,1662,938,14,74,45,29,360,319,8,32,1,59
"2011","South Lakeland 011","E02004025","Total",3656,2890,1809,1081,11,326,225,101,378,329,8,36,5,51
"2011","South Lakeland 012","E02004026","Total",3745,2473,1269,1204,19,597,522,75,595,532,12,44,7,61
"2011","South Lakeland 013","E02004027","Total",3744,2968,2080,888,16,253,182,71,420,357,14,43,6,87
"2011","South Lakeland 014","E02004028","Total",3438,2979,1852,1127,7,169,118,51,248,221,4,18,5,35
"2011","Bolton 001","E02000984","Total",3146,2793,1332,1461,4,27,22,5,300,271,2,23,4,22
"2011","Bolton 002","E02000985","Total",3205,2828,1550,1278,5,129,46,83,226,202,4,19,1,17
"2011","Bolton 003","E02000986","Total",3682,2883,1406,1477,17,178,126,52,552,504,0,44,4,52
"2011","Bolton 004","E02000987","Total",3288,2074,957,1117,31,649,432,217,483,429,4,47,3,51
"2011","Bolton 005","E02000988","Total",3496,2105,979,1126,9,760,582,178,555,510,1,36,8,67
"2011","Bolton 006","E02000989","Total",3637,3208,1804,1404,19,180,86,94,199,162,2,32,3,31
"2011","Bolton 007","E02000990","Total",3286,2567,1131,1436,10,266,150,116,421,388,3,29,1,22
"2011","Bolton 008","E02000991","Total",3316,2662,1274,1388,10,204,99,105,409,357,0,47,5,31
"2011","Bolton 009","E02000992","Total",2518,2077,1006,1071,6,181,164,17,229,207,0,20,2,25
"2011","Bolton 010","E02000993","Total",3135,1118,433,685,19,1438,1261,177,498,468,2,22,6,62
"2011","Bolton 011","E02000994","Total",3343,1319,641,678,24,1359,878,481,553,514,1,33,5,88
"2011","Bolton 012","E02000995","Total",3430,2288,1248,1040,15,752,652,100,317,286,3,19,9,58
"2011","Bolton 013","E02000996","Total",3321,1271,578,693,4,1748,1583,165,213,193,3,15,2,85
"2011","Bolton 014","E02000997","Total",2372,1726,871,855,6,458,277,181,164,145,0,18,1,18
"2011","Bolton 015","E02000998","Total",3654,1800,911,889,8,550,331,219,1225,1161,5,45,14,71
"2011","Bolton 016","E02000999","Total",3580,724,369,355,26,2093,1476,617,606,568,0,21,17,131
"2011","Bolton 017","E02001000","Total",4123,2436,1151,1285,15,673,322,351,935,868,2,57,8,64
"2011","Bolton 018","E02001001","Total",3197,2275,1060,1215,14,245,177,68,615,582,2,31,0,48
"2011","Bolton 019","E02001002","Total",4018,2722,1228,1494,25,862,565,297,365,321,1,39,4,44
"2011","Bolton 020","E02001003","Total",2850,2596,1487,1109,10,49,19,30,171,157,0,12,2,24
"2011","Bolton 021","E02001004","Total",3185,1196,799,397,6,1369,1089,280,484,448,3,22,11,130
"2011","Bolton 022","E02001005","Total",3130,1479,723,756,44,811,380,431,723,679,1,35,8,73
"2011","Bolton 023","E02001006","Total",2801,1720,927,793,19,411,175,236,596,542,4,31,19,55
"2011","Bolton 024","E02001007","Total",4396,3342,1667,1675,31,558,415,143,422,359,4,53,6,43
"2011","Bolton 025","E02001008","Total",2843,1162,589,573,20,1160,820,340,414,382,1,21,10,87
"2011","Bolton 026","E02001009","Total",2975,1649,805,844,6,822,325,497,451,411,3,31,6,47
"2011","Bolton 027","E02001010","Total",2468,1339,596,743,30,565,352,213,505,462,4,25,14,29
"2011","Bolton 028","E02001011","Total",4125,3381,1448,1933,25,202,79,123,489,439,1,47,2,28
"2011","Bolton 029","E02001012","Total",2919,2038,919,1119,8,534,506,28,285,268,0,15,2,54
"2011","Bolton 030","E02001013","Total",2495,2090,1070,1020,23,134,93,41,225,200,0,22,3,23
"2011","Bolton 031","E02001014","Total",3650,2226,871,1355,16,856,550,306,507,457,4,42,4,45
"2011","Bolton 032","E02001015","Total",3762,1936,809,1127,29,1143,696,447,572,511,5,45,11,82
"2011","Bolton 033","E02001016","Total",3354,1440,532,908,51,1473,1156,317,323,295,2,22,4,67
"2011","Bolton 034","E02001017","Total",4663,3201,1300,1901,7,784,629,155,630,573,5,46,6,41
"2011","Bolton 035","E02001018","Total",3008,2499,907,1592,13,202,62,140,268,236,1,28,3,26
"2011","Bury 001","E02001019","Total",3982,2866,1252,1614,13,439,280,159,617,559,4,47,7,47
"2011","Bury 002","E02001020","Total",2483,2217,1291,926,0,99,94,5,143,118,4,20,1,24
"2011","Bury 003","E02001021","Total",3115,2701,1135,1566,4,80,58,22,295,267,1,25,2,35
"2011","Bury 004","E02001022","Total",3326,2434,1229,1205,25,433,360,73,394,349,2,40,3,40
"2011","Bury 005","E02001023","Total",2324,1685,808,877,1,417,334,83,196,181,0,15,0,25
"2011","Bury 006","E02001024","Total",3341,2845,1233,1612,4,168,124,44,300,264,0,32,4,24
"2011","Bury 007","E02001025","Total",3349,1615,723,892,16,1304,1096,208,350,303,3,38,6,64
"2011","Bury 008","E02001026","Total",3671,1889,748,1141,21,704,264,440,978,914,5,46,13,79
"2011","Bury 009","E02001027","Total",3029,1940,744,1196,10,347,285,62,687,640,2,41,4,45
"2011","Bury 010","E02001028","Total",3108,2860,1599,1261,1,119,51,68,103,90,2,10,1,25
"2011","Bury 011","E02001029","Total",2880,1715,776,939,10,612,284,328,472,433,2,34,3,71
"2011","Bury 012","E02001030","Total",2346,1954,834,1120,14,181,128,53,172,157,1,13,1,25
"2011","Bury 013","E02001031","Total",2841,1789,786,1003,11,547,315,232,457,420,0,30,7,37
"2011","Bury 014","E02001032","Total",3120,2461,1078,1383,19,246,227,19,370,327,2,41,0,24
"2011","Bury 015","E02001033","Total",2390,1489,589,900,15,415,195,220,442,411,0,23,8,29
"2011","Bury 016","E02001034","Total",3831,1543,593,950,17,1478,854,624,739,690,0,46,3,54
"2011","Bury 017","E02001035","Total",2981,2612,1419,1193,5,99,58,41,234,201,3,29,1,31
"2011","Bury 018","E02001036","Total",3011,2051,822,1229,3,526,437,89,401,360,1,38,2,30
"2011","Bury 019","E02001037","Total",3016,2601,1396,1205,9,52,30,22,321,297,1,21,2,33
"2011","Bury 020","E02001038","Total",2637,1582,675,907,6,550,448,102,447,419,0,24,4,52
"2011","Bury 021","E02001039","Total",3443,1858,721,1137,8,1182,347,835,363,338,1,21,3,32
"2011","Bury 022","E02001040","Total",2548,2104,1047,1057,7,80,59,21,328,298,2,26,2,29
"2011","Bury 023","E02001041","Total",3369,2090,850,1240,16,658,470,188,564,521,5,32,6,41
"2011","Bury 024","E02001042","Total",2875,1811,876,935,3,398,135,263,625,586,2,32,5,38
"2011","Bury 025","E02001043","Total",2307,1584,683,901,4,415,284,131,275,258,0,15,2,29
"2011","Bury 026","E02001044","Total",2790,2099,932,1167,5,154,97,57,501,458,1,41,1,31
"2011","Manchester 001","E02001045","Total",3622,1561,731,830,15,1625,1171,454,364,330,2,27,5,57
"2011","Manchester 002","E02001046","Total",3956,1743,683,1060,54,1558,1190,368,558,505,2,41,10,43
"2011","Manchester 003","E02001047","Total",4369,1922,713,1209,19,1868,1526,342,492,446,2,37,7,68
"2011","Manchester 004","E02001048","Total",3560,2049,959,1090,22,639,320,319,805,744,1,54,6,45
"2011","Manchester 005","E02001049","Total",4049,2664,1167,1497,22,909,663,246,395,357,0,34,4,59
"2011","Manchester 006","E02001050","Total",3195,1205,517,688,42,889,546,343,1016,978,4,29,5,43
"2011","Manchester 007","E02001051","Total",3393,1945,906,1039,8,510,299,211,883,827,1,46,9,47
"2011","Manchester 008","E02001052","Total",4384,1767,872,895,63,804,209,595,1667,1590,3,57,17,83
"2011","Manchester 009","E02001053","Total",4494,839,353,486,40,2763,1924,839,750,706,4,28,12,102
"2011","Manchester 011","E02001055","Total",3829,1534,635,899,18,1488,1021,467,712,667,5,34,6,77
"2011","Manchester 012","E02001056","Total",3463,857,389,468,16,2046,975,1071,478,446,1,15,16,66
"2011","Manchester 013","E02001057","Total",4018,675,224,451,14,1846,1043,803,1411,1364,1,25,21,72
"2011","Manchester 015","E02001059","Total",4369,1091,422,669,56,1989,500,1489,1140,1075,6,36,23,93
"2011","Manchester 017","E02001061","Total",3863,1361,619,742,41,1608,384,1224,789,742,1,26,20,64
"2011","Manchester 018","E02001062","Total",3546,520,205,315,16,2324,1424,900,597,527,9,24,37,89
"2011","Manchester 019","E02001063","Total",3629,705,173,532,13,1370,352,1018,1489,1413,2,48,26,52
"2011","Manchester 020","E02001064","Total",3624,1047,391,656,6,1807,776,1031,673,616,2,33,22,91
"2011","Manchester 021","E02001065","Total",3787,1901,829,1072,28,630,170,460,1151,1083,2,52,14,77
"2011","Manchester 022","E02001066","Total",3533,780,374,406,15,885,184,701,1793,1717,3,34,39,60
"2011","Manchester 023","E02001067","Total",3791,934,334,600,47,1867,543,1324,870,819,1,33,17,73
"2011","Manchester 024","E02001068","Total",3696,629,269,360,17,2180,632,1548,772,710,0,35,27,98
"2011","Manchester 025","E02001069","Total",4059,933,443,490,33,1291,242,1049,1721,1637,3,65,16,81
"2011","Manchester 026","E02001070","Total",3294,989,427,562,24,788,242,546,1420,1337,3,45,35,73
"2011","Manchester 027","E02001071","Total",4566,1918,755,1163,29,971,170,801,1548,1455,5,61,27,100
"2011","Manchester 028","E02001072","Total",3741,1360,516,844,25,728,56,672,1585,1523,4,46,12,43
"2011","Manchester 029","E02001073","Total",4015,2218,917,1301,6,406,17,389,1361,1309,4,37,11,24
"2011","Manchester 030","E02001074","Total",4299,1625,614,1011,44,1505,737,768,1059,995,5,47,12,66
"2011","Manchester 031","E02001075","Total",3320,1530,547,983,47,466,59,407,1242,1176,2,54,10,35
"2011","Manchester 032","E02001076","Total",2965,756,380,376,17,336,92,244,1827,1758,1,36,32,29
"2011","Manchester 033","E02001077","Total",3117,1827,816,1011,19,276,52,224,965,939,3,19,4,30
"2011","Manchester 034","E02001078","Total",3835,2375,1056,1319,43,558,87,471,817,745,1,54,17,42
"2011","Manchester 035","E02001079","Total",3341,1137,457,680,31,1271,501,770,844,801,1,39,3,58
"2011","Manchester 036","E02001080","Total",3367,988,518,470,26,458,124,334,1853,1802,1,43,7,42
"2011","Manchester 037","E02001081","Total",2776,1720,660,1060,25,452,107,345,554,515,2,28,9,25
"2011","Manchester 038","E02001082","Total",2921,1138,484,654,10,333,104,229,1415,1361,2,48,4,25
"2011","Manchester 039","E02001083","Total",3902,1356,333,1023,19,593,201,392,1898,1850,1,34,13,36
"2011","Manchester 040","E02001084","Total",3325,1591,707,884,12,641,204,437,1047,997,9,34,7,34
"2011","Manchester 041","E02001085","Total",3177,1180,410,770,26,1609,731,878,296,256,2,29,9,66
"2011","Manchester 042","E02001086","Total",2949,1409,517,892,17,858,331,527,619,588,0,28,3,46
"2011","Manchester 043","E02001087","Total",4402,2585,1175,1410,7,417,69,348,1331,1253,7,58,13,62
"2011","Manchester 044","E02001088","Total",3780,1780,580,1200,20,1499,675,824,420,374,3,31,12,61
"2011","Manchester 045","E02001089","Total",3123,2296,1112,1184,35,142,26,116,600,568,3,27,2,50
"2011","Manchester 046","E02001090","Total",3100,1960,861,1099,25,615,158,457,461,428,1,28,4,39
"2011","Manchester 047","E02001091","Total",3876,2164,822,1342,48,1163,373,790,455,414,1,36,4,46
"2011","Manchester 048","E02001092","Total",3724,1704,561,1143,28,1514,721,793,423,381,1,38,3,55
"2011","Manchester 049","E02001093","Total",3778,1330,337,993,14,1787,595,1192,595,562,1,22,10,52
"2011","Manchester 050","E02001094","Total",3805,738,225,513,11,2591,853,1738,391,359,0,19,13,74
"2011","Manchester 051","E02001095","Total",3580,1369,467,902,35,1695,709,986,418,351,26,27,14,63
"2011","Manchester 052","E02001096","Total",3311,1632,654,978,25,1307,446,861,307,268,3,30,6,40
"2011","Manchester 053","E02001097","Total",3452,1396,481,915,20,1514,570,944,455,407,0,39,9,67
"2011","Manchester 054","E02006902","Total",3368,612,186,426,86,780,518,262,1837,1781,4,37,15,53
"2011","Manchester 055","E02006912","Total",3885,935,272,663,20,370,107,263,2510,2399,5,82,24,50
"2011","Manchester 056","E02006913","Total",2939,602,302,300,19,915,568,347,1369,1323,2,26,18,34
"2011","Manchester 057","E02006914","Total",2299,425,155,270,7,571,95,476,1262,1191,3,37,31,34
"2011","Manchester 058","E02006915","Total",3047,604,183,421,25,1493,756,737,869,833,0,31,5,56
"2011","Manchester 059","E02006916","Total",3274,567,131,436,16,1119,426,693,1530,1464,2,28,36,42
"2011","Manchester 060","E02006917","Total",3087,917,319,598,15,45,11,34,2061,1981,4,62,14,49
"2011","Oldham 001","E02001098","Total",2756,2121,1201,920,17,392,230,162,193,167,0,22,4,33
"2011","Oldham 002","E02001099","Total",2724,1749,778,971,22,514,159,355,406,373,0,30,3,33
"2011","Oldham 003","E02001100","Total",2586,1963,972,991,5,348,219,129,237,217,0,18,2,33
"2011","Oldham 004","E02001101","Total",2457,2090,1063,1027,6,183,115,68,163,141,0,20,2,15
"2011","Oldham 005","E02001102","Total",2475,2040,813,1227,12,126,68,58,277,235,3,35,4,20
"2011","Oldham 006","E02001103","Total",2353,1855,1006,849,20,240,97,143,207,171,3,27,6,31
"2011","Oldham 007","E02001104","Total",2726,1940,637,1303,7,535,366,169,230,196,0,33,1,14
"2011","Oldham 008","E02001105","Total",2631,1835,942,893,32,567,309,258,169,134,0,31,4,28
"2011","Oldham 009","E02001106","Total",2668,1844,870,974,9,494,122,372,302,267,0,32,3,19
"2011","Oldham 010","E02001107","Total",2390,1760,855,905,13,342,218,124,244,209,2,29,4,31
"2011","Oldham 011","E02001108","Total",2148,1027,399,628,18,738,466,272,350,316,1,31,2,15
"2011","Oldham 012","E02001109","Total",3332,1775,652,1123,15,1108,597,511,389,350,1,27,11,45
"2011","Oldham 013","E02001110","Total",2742,2307,1212,1095,8,38,13,25,361,322,2,32,5,28
"2011","Oldham 014","E02001111","Total",2928,671,278,393,23,1885,1125,760,294,259,7,19,9,55
"2011","Oldham 015","E02001112","Total",2371,2192,1075,1117,0,21,4,17,138,104,2,32,0,20
"2011","Oldham 016","E02001113","Total",2664,1320,494,826,8,896,338,558,389,332,3,50,4,51
"2011","Oldham 017","E02001114","Total",3381,2121,869,1252,13,858,551,307,346,288,5,42,11,43
"2011","Oldham 018","E02001115","Total",2539,1821,807,1014,7,391,243,148,297,258,1,34,4,23
"2011","Oldham 019","E02001116","Total",2358,1566,703,863,16,183,83,100,537,479,1,50,7,56
"2011","Oldham 020","E02001117","Total",2529,1991,1074,917,10,215,111,104,294,268,3,21,2,19
"2011","Oldham 021","E02001118","Total",2602,2099,1027,1072,4,191,111,80,273,249,2,21,1,35
"2011","Oldham 022","E02001119","Total",2840,1675,937,738,12,557,156,401,505,421,2,61,21,91
"2011","Oldham 024","E02001121","Total",2224,1084,536,548,4,596,247,349,483,438,1,36,8,57
"2011","Oldham 026","E02001123","Total",2751,1330,551,779,7,1082,691,391,284,249,0,24,11,48
"2011","Oldham 027","E02001124","Total",2507,1193,498,695,9,933,389,544,338,310,1,19,8,34
"2011","Oldham 028","E02001125","Total",3351,2533,1123,1410,8,368,194,174,417,374,3,34,6,25
"2011","Oldham 029","E02001126","Total",3141,1364,514,850,4,1203,247,956,518,466,2,39,11,52
"2011","Oldham 030","E02001127","Total",2790,1198,558,640,6,1263,180,1083,289,269,1,13,6,34
"2011","Oldham 031","E02001128","Total",3271,2272,1047,1225,7,451,174,277,506,455,4,40,7,35
"2011","Oldham 032","E02001129","Total",2622,1360,525,835,6,691,267,424,530,488,2,33,7,35
"2011","Oldham 033","E02001130","Total",2520,1833,840,993,4,483,285,198,162,137,2,19,4,38
"2011","Oldham 034","E02001131","Total",2298,1822,980,842,3,265,127,138,180,156,0,22,2,28
"2011","Oldham 035","E02006860","Total",4028,2508,1357,1151,17,761,206,555,636,578,3,42,13,106
"2011","Rochdale 001","E02001132","Total",2860,2014,924,1090,3,302,240,62,509,465,5,36,3,32
"2011","Rochdale 002","E02001133","Total",2544,2042,930,1112,2,178,145,33,299,261,2,36,0,23
"2011","Rochdale 003","E02001134","Total",2583,2132,979,1153,3,93,88,5,325,298,4,20,3,30
"2011","Rochdale 004","E02001135","Total",3052,1130,416,714,22,1558,1208,350,291,262,1,25,3,51
"2011","Rochdale 005","E02001136","Total",3667,2654,1199,1455,9,516,398,118,439,400,0,36,3,49
"2011","Rochdale 006","E02001137","Total",2497,2167,951,1216,2,52,26,26,251,219,3,27,2,25
"2011","Rochdale 007","E02001138","Total",3647,2948,1451,1497,10,307,285,22,350,310,1,34,5,32
"2011","Rochdale 008","E02001139","Total",2906,1692,734,958,11,581,316,265,565,520,0,36,9,57
"2011","Rochdale 009","E02001140","Total",2958,1714,779,935,5,741,586,155,467,425,2,38,2,31
"2011","Rochdale 010","E02001141","Total",5181,1803,859,944,22,2342,1887,455,852,790,5,45,12,162
"2011","Rochdale 011","E02001142","Total",2396,2062,1188,874,5,66,45,21,249,225,2,20,2,14
"2011","Rochdale 012","E02001143","Total",3988,2140,871,1269,8,1176,707,469,607,559,2,40,6,57
"2011","Rochdale 013","E02001144","Total",2702,1723,743,980,5,508,406,102,440,413,2,24,1,26
"2011","Rochdale 014","E02001145","Total",3024,2209,961,1248,9,387,308,79,363,330,1,28,4,56
"2011","Rochdale 015","E02001146","Total",2896,1602,861,741,7,587,204,383,631,581,4,32,14,69
"2011","Rochdale 016","E02001147","Total",3878,1650,678,972,9,1719,1569,150,438,398,0,35,5,62
"2011","Rochdale 017","E02001148","Total",4257,2784,1293,1491,23,703,455,248,685,628,1,46,10,62
"2011","Rochdale 018","E02001149","Total",4671,2157,951,1206,33,1693,1210,483,715,654,3,50,8,73
"2011","Rochdale 019","E02001150","Total",3591,2022,846,1176,4,1201,356,845,325,284,1,31,9,39
"2011","Rochdale 020","E02001151","Total",3867,2879,1231,1648,32,372,236,136,547,501,1,43,2,37
"2011","Rochdale 021","E02001152","Total",3984,2350,1006,1344,43,1052,872,180,476,425,5,38,8,63
"2011","Rochdale 022","E02001153","Total",4452,1811,674,1137,21,2156,598,1558,399,369,2,23,5,65
"2011","Rochdale 023","E02001154","Total",4387,2972,1056,1916,11,757,548,209,601,528,2,68,3,46
"2011","Rochdale 024","E02001155","Total",3433,2086,873,1213,21,812,654,158,468,422,2,35,9,46
"2011","Rochdale 025","E02001156","Total",4131,3406,1880,1526,20,388,324,64,264,244,0,18,2,53
"2011","Salford 001","E02001157","Total",3183,1108,423,685,15,1679,1138,541,316,285,3,24,4,65
"2011","Salford 002","E02001158","Total",2700,1342,542,800,3,943,664,279,336,314,2,17,3,76
"2011","Salford 003","E02001159","Total",2579,1389,541,848,23,748,451,297,379,348,1,25,5,40
"2011","Salford 004","E02001160","Total",2555,1218,514,704,4,1086,768,318,200,184,0,12,4,47
"2011","Salford 005","E02001161","Total",2680,1718,764,954,4,475,253,222,442,417,2,18,5,41
"2011","Salford 006","E02001162","Total",2709,1651,848,803,3,620,380,240,400,372,3,22,3,35
"2011","Salford 007","E02001163","Total",4182,3043,1422,1621,22,565,321,244,503,451,5,37,10,49
"2011","Salford 008","E02001164","Total",2677,1401,513,888,11,870,603,267,358,332,2,20,4,37
"2011","Salford 009","E02001165","Total",2664,1752,742,1010,6,557,459,98,317,283,0,33,1,32
"2011","Salford 010","E02001166","Total",2343,1080,564,516,9,560,220,340,642,592,1,39,10,52
"2011","Salford 011","E02001167","Total",2710,1394,655,739,6,593,451,142,666,630,4,29,3,51
"2011","Salford 012","E02001168","Total",4093,2423,1007,1416,12,1073,655,418,526,469,2,45,10,59
"2011","Salford 013","E02001169","Total",4252,3711,1651,2060,7,112,66,46,391,355,5,28,3,31
"2011","Salford 014","E02001170","Total",4130,3523,1796,1727,7,143,43,100,417,372,5,40,0,40
"2011","Salford 015","E02001171","Total",2336,2003,973,1030,6,89,28,61,229,210,1,17,1,9
"2011","Salford 016","E02001172","Total",4989,997,446,551,62,2718,1088,1630,1067,1001,3,45,18,145
"2011","Salford 017","E02001173","Total",3153,815,390,425,17,1535,1057,478,707,693,1,11,2,79
"2011","Salford 018","E02001174","Total",2362,1748,762,986,9,176,14,162,400,377,0,17,6,29
"2011","Salford 019","E02001175","Total",2914,1634,690,944,5,803,521,282,423,400,2,16,5,49
"2011","Salford 020","E02001176","Total",5147,2712,1220,1492,24,1327,779,548,1000,934,4,48,14,84
"2011","Salford 021","E02001177","Total",5293,2537,1185,1352,13,1455,904,551,1199,1141,1,50,7,89
"2011","Salford 022","E02001178","Total",5633,922,284,638,46,2022,1432,590,2557,2432,12,53,60,86
"2011","Salford 023","E02001179","Total",2874,1408,625,783,71,613,179,434,738,696,1,35,6,44
"2011","Salford 024","E02001180","Total",2981,217,98,119,9,2367,1787,580,306,296,1,2,7,82
"2011","Salford 025","E02001181","Total",2606,1117,460,657,8,1180,741,439,250,222,1,27,0,51
"2011","Salford 026","E02001182","Total",2858,1085,391,694,29,1296,733,563,395,356,2,25,12,53
"2011","Salford 027","E02001183","Total",2782,1542,601,941,40,581,294,287,573,536,3,26,8,46
"2011","Salford 028","E02001184","Total",5710,1242,330,912,21,1656,1281,375,2711,2649,5,48,9,80
"2011","Salford 029","E02001185","Total",4208,2811,1193,1618,6,977,520,457,377,339,3,28,7,37
"2011","Salford 030","E02001186","Total",4253,2583,973,1610,10,1000,631,369,595,538,6,35,16,65
"2011","Stockport 001","E02001187","Total",3076,2328,973,1355,5,358,166,192,367,342,0,24,1,18
"2011","Stockport 002","E02001188","Total",3503,1937,695,1242,70,785,523,262,658,616,0,39,3,53
"2011","Stockport 003","E02001189","Total",3616,2736,1220,1516,25,366,206,160,458,415,2,39,2,31
"2011","Stockport 004","E02001190","Total",3053,859,351,508,48,1918,1784,134,149,127,1,16,5,79
"2011","Stockport 005","E02001191","Total",2618,1880,960,920,28,500,352,148,180,155,1,22,2,30
"2011","Stockport 006","E02001192","Total",2831,1925,906,1019,3,201,74,127,677,646,6,23,2,25
"2011","Stockport 007","E02001193","Total",2952,1822,755,1067,4,556,368,188,538,495,2,38,3,32
"2011","Stockport 008","E02001194","Total",2493,1924,1002,922,5,84,6,78,460,446,2,11,1,20
"2011","Stockport 009","E02001195","Total",3208,2544,1100,1444,48,120,72,48,473,417,7,39,10,23
"2011","Stockport 010","E02001196","Total",3339,2572,1384,1188,15,458,316,142,247,224,2,17,4,47
"2011","Stockport 011","E02001197","Total",2610,1972,926,1046,14,363,240,123,241,226,0,13,2,20
"2011","Stockport 012","E02001198","Total",3341,2111,1058,1053,51,904,326,578,239,215,0,20,4,36
"2011","Stockport 013","E02001199","Total",3413,2736,1297,1439,19,58,3,55,566,528,2,31,5,34
"2011","Stockport 014","E02001200","Total",3446,992,391,601,63,1776,1242,534,556,512,5,24,15,59
"2011","Stockport 015","E02001201","Total",2431,1932,781,1151,22,104,41,63,350,311,0,36,3,23
"2011","Stockport 016","E02001202","Total",2998,1651,541,1110,38,641,405,236,641,599,5,30,7,27
"2011","Stockport 017","E02001203","Total",2387,2145,1233,912,2,42,37,5,179,158,0,16,5,19
"2011","Stockport 018","E02001204","Total",3803,2822,1100,1722,42,427,297,130,496,454,3,35,4,16
"2011","Stockport 019","E02001205","Total",3645,2222,892,1330,38,788,297,491,568,528,1,33,6,29
"2011","Stockport 020","E02001206","Total",2940,2274,1274,1000,8,363,215,148,275,237,1,30,7,20
"2011","Stockport 021","E02001207","Total",2942,2447,1122,1325,3,256,72,184,213,186,1,22,4,23
"2011","Stockport 022","E02001208","Total",3261,2268,875,1393,9,493,280,213,455,415,4,32,4,36
"2011","Stockport 023","E02001209","Total",3382,2242,839,1403,54,373,259,114,685,633,2,47,3,28
"2011","Stockport 024","E02001210","Total",2889,1692,768,924,30,965,632,333,167,145,0,20,2,35
"2011","Stockport 025","E02001211","Total",2413,2083,1007,1076,16,86,16,70,203,187,2,12,2,25
"2011","Stockport 026","E02001212","Total",2563,1111,342,769,33,1183,866,317,204,193,0,11,0,32
"2011","Stockport 027","E02001213","Total",3991,2988,1341,1647,91,296,40,256,588,538,3,38,9,28
"2011","Stockport 028","E02001214","Total",3081,2318,1311,1007,22,459,391,68,235,199,2,32,2,47
"2011","Stockport 029","E02001215","Total",2502,2026,1135,891,16,255,176,79,186,159,4,17,6,19
"2011","Stockport 030","E02001216","Total",2986,2607,1353,1254,18,99,80,19,239,206,4,28,1,23
"2011","Stockport 031","E02001217","Total",3066,2148,997,1151,42,335,267,68,500,460,2,33,5,41
"2011","Stockport 032","E02001218","Total",2375,2033,1058,975,8,166,28,138,153,143,0,10,0,15
"2011","Stockport 033","E02001219","Total",2240,2097,1111,986,4,7,3,4,118,100,2,16,0,14
"2011","Stockport 034","E02001220","Total",2270,1824,897,927,14,269,170,99,139,118,1,19,1,24
"2011","Stockport 035","E02001221","Total",2361,2171,1169,1002,14,55,20,35,115,106,0,9,0,6
"2011","Stockport 036","E02001222","Total",2375,2163,1198,965,6,16,14,2,164,145,4,15,0,26
"2011","Stockport 037","E02001223","Total",2797,2464,1274,1190,22,33,7,26,251,228,3,18,2,27
"2011","Stockport 038","E02001224","Total",2577,2362,1407,955,5,48,35,13,136,122,2,9,3,26
"2011","Stockport 039","E02001225","Total",2947,2490,1265,1225,4,123,107,16,304,277,2,23,2,26
"2011","Stockport 040","E02001226","Total",2722,2247,1098,1149,20,196,95,101,235,198,1,36,0,24
"2011","Stockport 041","E02001227","Total",2376,2208,1273,935,4,37,3,34,108,101,0,7,0,19
"2011","Stockport 042","E02001228","Total",2160,1943,1082,861,4,58,46,12,136,121,1,11,3,19
"2011","Tameside 001","E02001229","Total",4417,3211,1312,1899,11,393,76,317,757,689,4,55,9,45
"2011","Tameside 002","E02001230","Total",2392,1943,1016,927,4,241,68,173,174,153,2,17,2,30
"2011","Tameside 003","E02001231","Total",2846,1897,733,1164,6,706,204,502,211,179,2,26,4,26
"2011","Tameside 004","E02001232","Total",3504,2026,892,1134,7,857,252,605,574,535,1,29,9,40
"2011","Tameside 005","E02001233","Total",3258,2024,920,1104,25,885,273,612,278,243,1,28,6,46
"2011","Tameside 006","E02001234","Total",3256,1652,686,966,8,1083,334,749,482,442,2,27,11,31
"2011","Tameside 007","E02001235","Total",2814,1896,859,1037,10,275,74,201,604,548,3,46,7,29
"2011","Tameside 008","E02001236","Total",2509,1164,473,691,9,971,290,681,325,291,1,24,9,40
"2011","Tameside 009","E02001237","Total",2932,1640,558,1082,8,750,244,506,499,456,2,32,9,35
"2011","Tameside 010","E02001238","Total",3422,2322,1014,1308,18,639,113,526,402,355,2,34,11,41
"2011","Tameside 011","E02001239","Total",3897,2476,1049,1427,5,653,161,492,714,658,1,48,7,49
"2011","Tameside 012","E02001240","Total",2597,2066,931,1135,5,95,7,88,408,367,2,38,1,23
"2011","Tameside 013","E02001241","Total",4252,1293,571,722,10,1873,173,1700,1010,934,5,44,27,66
"2011","Tameside 014","E02001242","Total",2360,1988,984,1004,8,77,5,72,265,227,4,31,3,22
"2011","Tameside 015","E02001243","Total",3529,2514,1208,1306,21,502,125,377,455,421,4,28,2,37
"2011","Tameside 016","E02001244","Total",2275,1997,972,1025,3,75,31,44,177,148,3,21,5,23
"2011","Tameside 017","E02001245","Total",3573,2029,742,1287,4,970,240,730,532,484,5,37,6,38
"2011","Tameside 018","E02001246","Total",3118,1719,736,983,6,1128,332,796,229,202,0,17,10,36
"2011","Tameside 019","E02001247","Total",3064,1837,742,1095,12,835,170,665,344,294,4,42,4,36
"2011","Tameside 020","E02001248","Total",4547,2402,808,1594,8,1473,431,1042,615,558,3,47,7,49
"2011","Tameside 021","E02001249","Total",2811,1880,843,1037,9,349,82,267,547,504,2,35,6,26
"2011","Tameside 022","E02001250","Total",2679,2207,898,1309,20,184,44,140,244,217,1,23,3,24
"2011","Tameside 023","E02001251","Total",2750,2021,1003,1018,25,305,67,238,381,340,2,29,10,18
"2011","Tameside 024","E02001252","Total",3293,2857,1489,1368,2,121,7,114,279,239,0,37,3,34
"2011","Tameside 025","E02001253","Total",2267,1678,751,927,3,249,84,165,309,279,1,27,2,28
"2011","Tameside 026","E02001254","Total",2484,1674,767,907,7,561,154,407,211,178,1,29,3,31
"2011","Tameside 027","E02001255","Total",2672,979,386,593,7,1517,452,1065,128,117,0,8,3,41
"2011","Tameside 028","E02001256","Total",4015,2218,833,1385,30,986,170,816,742,682,0,50,10,39
"2011","Tameside 029","E02001257","Total",4272,2359,1173,1186,11,1482,251,1231,352,316,3,20,13,68
"2011","Tameside 030","E02001258","Total",3148,2589,1339,1250,7,203,39,164,325,289,2,31,3,24
"2011","Trafford 001","E02001259","Total",4162,1415,687,728,22,1810,524,1286,846,805,3,30,8,69
"2011","Trafford 002","E02001260","Total",3031,2505,1135,1370,13,284,128,156,199,171,1,26,1,30
"2011","Trafford 003","E02001261","Total",3451,2092,770,1322,10,642,229,413,678,624,1,47,6,29
"2011","Trafford 004","E02001262","Total",3009,1905,919,986,9,668,229,439,368,341,0,17,10,59
"2011","Trafford 005","E02001263","Total",3293,2854,1453,1401,18,141,80,61,250,226,0,23,1,30
"2011","Trafford 006","E02001264","Total",3230,2386,1051,1335,17,443,150,293,350,309,1,36,4,34
"2011","Trafford 007","E02001265","Total",3369,2528,1075,1453,17,585,256,329,209,193,0,14,2,30
"2011","Trafford 008","E02001266","Total",3033,1709,738,971,36,1012,325,687,235,214,0,20,1,41
"2011","Trafford 009","E02001267","Total",3363,2098,884,1214,34,683,172,511,508,482,1,20,5,40
"2011","Trafford 010","E02001268","Total",2972,2503,1254,1249,35,213,70,143,194,178,3,11,2,27
"2011","Trafford 011","E02001269","Total",3628,2142,982,1160,12,809,250,559,636,593,3,33,7,29
"2011","Trafford 012","E02001270","Total",3418,2481,1052,1429,19,270,61,209,610,578,0,30,2,38
"2011","Trafford 013","E02001271","Total",2874,1915,835,1080,5,673,146,527,245,216,4,23,2,36
"2011","Trafford 014","E02001272","Total",3396,2712,1349,1363,2,189,41,148,473,439,0,31,3,20
"2011","Trafford 015","E02001273","Total",4242,2540,1161,1379,39,316,59,257,1313,1263,3,37,10,34
"2011","Trafford 016","E02001274","Total",3188,2767,1539,1228,7,154,40,114,228,208,1,17,2,32
"2011","Trafford 017","E02001275","Total",3544,1705,709,996,9,1477,186,1291,310,272,1,29,8,43
"2011","Trafford 018","E02001276","Total",3299,2138,932,1206,10,873,445,428,237,212,2,20,3,41
"2011","Trafford 019","E02001277","Total",3786,1852,580,1272,80,1501,180,1321,315,285,1,25,4,38
"2011","Trafford 020","E02001278","Total",3271,2648,1210,1438,40,194,21,173,370,340,2,23,5,19
"2011","Trafford 021","E02001279","Total",3229,2918,1375,1543,5,106,24,82,190,174,0,15,1,10
"2011","Trafford 022","E02001280","Total",3558,2088,906,1182,44,1127,325,802,249,231,2,12,4,50
"2011","Trafford 023","E02001281","Total",3078,2737,1412,1325,15,84,22,62,222,205,3,14,0,20
"2011","Trafford 024","E02001282","Total",3883,2668,1100,1568,15,308,96,212,869,837,3,24,5,23
"2011","Trafford 025","E02001283","Total",3748,2541,1323,1218,33,383,130,253,721,673,10,23,15,70
"2011","Trafford 026","E02001284","Total",3131,2563,1124,1439,5,88,25,63,452,426,0,23,3,23
"2011","Trafford 027","E02001285","Total",3251,2423,1293,1130,19,268,87,181,503,474,5,18,6,38
"2011","Trafford 028","E02001286","Total",3047,2607,1474,1133,0,184,72,112,221,204,2,15,0,35
"2011","Wigan 001","E02001287","Total",2321,1930,910,1020,4,152,106,46,201,180,0,19,2,34
"2011","Wigan 002","E02001288","Total",3173,2485,1235,1250,0,371,339,32,275,257,2,12,4,42
"2011","Wigan 003","E02001289","Total",4248,3610,1903,1707,7,272,218,54,307,275,0,32,0,52
"2011","Wigan 004","E02001290","Total",2615,1886,947,939,3,451,419,32,231,208,1,17,5,44
"2011","Wigan 005","E02001291","Total",3199,1968,950,1018,4,874,827,47,306,271,6,23,6,47
"2011","Wigan 006","E02001292","Total",3528,2677,1490,1187,5,211,158,53,597,556,10,25,6,38
"2011","Wigan 007","E02001293","Total",2583,2006,961,1045,12,353,258,95,194,169,1,19,5,18
"2011","Wigan 008","E02001294","Total",3492,2432,1117,1315,3,322,98,224,705,661,4,39,1,30
"2011","Wigan 009","E02001295","Total",3641,1264,579,685,13,1818,1532,286,450,417,1,27,5,96
"2011","Wigan 010","E02001296","Total",3745,941,328,613,10,2398,2314,84,282,264,1,14,3,114
"2011","Wigan 011","E02001297","Total",2958,1834,824,1010,4,775,646,129,297,260,1,29,7,48
"2011","Wigan 012","E02001298","Total",3372,1543,659,884,6,1264,1094,170,489,445,0,37,7,70
"2011","Wigan 013","E02001299","Total",3708,2700,1132,1568,3,450,403,47,513,467,0,42,4,42
"2011","Wigan 014","E02001300","Total",3413,2285,1114,1171,8,587,466,121,481,445,2,29,5,52
"2011","Wigan 015","E02001301","Total",3823,1857,720,1137,11,1133,810,323,764,723,2,33,6,58
"2011","Wigan 016","E02001302","Total",3251,2014,866,1148,5,962,852,110,211,199,0,10,2,59
"2011","Wigan 017","E02001303","Total",3740,1662,709,953,4,1734,1669,65,264,242,1,17,4,76
"2011","Wigan 018","E02001304","Total",5320,4341,2244,2097,5,509,482,27,407,364,2,37,4,58
"2011","Wigan 019","E02001305","Total",3376,2915,1398,1517,7,168,160,8,261,226,2,29,4,25
"2011","Wigan 020","E02001306","Total",2989,2505,1262,1243,7,274,229,45,186,155,2,29,0,17
"2011","Wigan 021","E02001307","Total",4334,4097,1683,2414,6,18,13,5,197,168,2,27,0,16
"2011","Wigan 022","E02001308","Total",2672,1934,949,985,16,376,331,45,302,280,1,20,1,44
"2011","Wigan 023","E02001309","Total",3565,2510,1149,1361,16,361,288,73,636,588,1,44,3,42
"2011","Wigan 024","E02001310","Total",3766,2137,836,1301,3,893,658,235,680,642,1,31,6,53
"2011","Wigan 025","E02001311","Total",3706,2488,1060,1428,12,660,570,90,503,465,1,33,4,43
"2011","Wigan 026","E02001312","Total",3202,2168,913,1255,6,481,409,72,505,464,0,40,1,42
"2011","Wigan 027","E02001313","Total",3409,1819,749,1070,7,1198,1088,110,315,284,2,26,3,70
"2011","Wigan 028","E02001314","Total",3157,2467,905,1562,16,409,380,29,244,217,0,25,2,21
"2011","Wigan 029","E02001315","Total",3326,2628,1202,1426,2,367,354,13,282,238,0,42,2,47
"2011","Wigan 030","E02001316","Total",3095,1820,773,1047,9,276,148,128,949,899,2,46,2,41
"2011","Wigan 031","E02001317","Total",3602,2226,956,1270,26,941,862,79,366,343,1,21,1,43
"2011","Wigan 032","E02001318","Total",3397,2259,1166,1093,4,831,806,25,251,234,0,16,1,52
"2011","Wigan 033","E02001319","Total",3159,1871,815,1056,1,701,434,267,566,530,2,29,5,20
"2011","Wigan 034","E02001320","Total",3475,2253,1091,1162,21,665,585,80,501,459,3,34,5,35
"2011","Wigan 035","E02001321","Total",3375,2677,1133,1544,8,317,298,19,340,313,0,25,2,33
"2011","Wigan 036","E02001322","Total",3159,2526,1273,1253,4,225,210,15,364,331,0,32,1,40
"2011","Wigan 037","E02001323","Total",3356,2286,1062,1224,18,672,520,152,337,301,1,32,3,43
"2011","Wigan 038","E02001324","Total",3607,2275,972,1303,15,723,616,107,546,511,3,32,0,48
"2011","Wigan 039","E02001325","Total",3241,2717,1239,1478,12,242,210,32,251,223,2,24,2,19
"2011","Wigan 040","E02001326","Total",3288,2546,1172,1374,8,369,292,77,319,276,1,41,1,46
"2011","Burnley 001","E02005176","Total",3681,2856,1361,1495,8,381,111,270,401,351,2,44,4,35
"2011","Burnley 002","E02005177","Total",2482,1645,846,799,4,122,34,88,687,628,6,41,12,24
"2011","Burnley 003","E02005178","Total",3019,1655,976,679,7,293,36,257,981,881,9,83,8,83
"2011","Burnley 004","E02005179","Total",4114,2329,1118,1211,14,707,211,496,1004,937,1,58,8,60
"2011","Burnley 005","E02005180","Total",2906,2423,1117,1306,0,228,67,161,228,193,0,30,5,27
"2011","Burnley 006","E02005181","Total",2845,1784,761,1023,13,341,60,281,667,622,6,37,2,40
"2011","Burnley 007","E02005182","Total",2790,1359,641,718,6,578,97,481,805,747,1,51,6,42
"2011","Burnley 008","E02005183","Total",2844,1758,857,901,4,825,246,579,215,186,0,22,7,42
"2011","Burnley 009","E02005184","Total",2211,1898,1036,862,5,71,23,48,206,180,0,24,2,31
"2011","Burnley 010","E02005185","Total",3864,1710,795,915,4,1122,371,751,957,895,6,42,14,71
"2011","Burnley 011","E02005186","Total",2524,2074,880,1194,3,119,33,86,317,287,0,26,4,11
"2011","Burnley 014","E02006881","Total",4270,2917,1427,1490,11,494,129,365,799,757,3,35,4,49
"2011","Chorley 001","E02005189","Total",2360,1041,407,634,5,1129,48,1081,174,151,0,16,7,11
"2011","Chorley 002","E02005190","Total",2602,2195,1160,1035,18,133,22,111,229,202,2,20,5,27
"2011","Chorley 003","E02005191","Total",3457,3002,1341,1661,19,204,7,197,216,184,1,28,3,16
"2011","Chorley 004","E02005192","Total",3073,2561,980,1581,20,186,45,141,286,263,1,19,3,20
"2011","Chorley 005","E02005193","Total",3506,3069,1473,1596,14,162,50,112,229,194,2,31,2,32
"2011","Chorley 006","E02005194","Total",3528,2522,1289,1233,19,537,123,414,412,362,5,34,11,38
"2011","Chorley 007","E02005195","Total",2456,2014,1047,967,26,155,48,107,235,203,6,25,1,26
"2011","Chorley 008","E02005196","Total",3281,2405,1226,1179,34,493,17,476,324,297,2,18,7,25
"2011","Chorley 009","E02005197","Total",3003,1833,812,1021,21,703,178,525,401,343,0,51,7,45
"2011","Chorley 010","E02005198","Total",3747,2541,1218,1323,14,521,163,358,630,566,5,56,3,41
"2011","Chorley 011","E02005199","Total",3023,2631,1457,1174,40,131,50,81,194,171,3,18,2,27
"2011","Chorley 012","E02005200","Total",3523,2189,684,1505,24,775,309,466,500,452,0,41,7,35
"2011","Chorley 013","E02005201","Total",3264,2482,1155,1327,8,414,188,226,328,290,3,29,6,32
"2011","Chorley 014","E02005202","Total",4096,3298,1657,1641,21,300,128,172,429,388,2,28,11,48
"2011","Fylde 001","E02005203","Total",2968,2326,1313,1013,6,193,35,158,396,256,70,24,46,47
"2011","Fylde 002","E02005204","Total",4533,3321,1611,1710,45,486,88,398,620,546,8,53,13,61
"2011","Fylde 003","E02005205","Total",2564,2048,1042,1006,3,277,109,168,205,170,5,20,10,31
"2011","Fylde 004","E02005206","Total",3265,2349,1199,1150,17,348,60,288,512,460,0,46,6,39
"2011","Fylde 005","E02005207","Total",3782,3026,1798,1228,6,226,49,177,483,429,5,44,5,41
"2011","Fylde 006","E02005208","Total",5105,3038,1758,1280,14,180,19,161,1803,1722,8,66,7,70
"2011","Fylde 007","E02005209","Total",3565,2816,1539,1277,12,275,64,211,423,351,19,39,14,39
"2011","Fylde 008","E02005210","Total",4923,3731,2229,1502,18,366,41,325,740,670,3,65,2,68
"2011","Fylde 009","E02005211","Total",4180,2967,1725,1242,14,256,34,222,884,807,9,60,8,59
"2011","Hyndburn 001","E02005212","Total",4788,3366,1757,1609,27,448,111,337,901,839,1,57,4,46
"2011","Hyndburn 002","E02005213","Total",4891,3561,1463,2098,14,453,164,289,816,734,2,72,8,47
"2011","Hyndburn 003","E02005214","Total",2912,2037,1016,1021,3,224,54,170,628,586,2,39,1,20
"2011","Hyndburn 004","E02005215","Total",5338,3421,1679,1742,9,783,289,494,1055,972,1,77,5,70
"2011","Hyndburn 005","E02005216","Total",2304,1374,652,722,3,490,188,302,410,371,1,35,3,27
"2011","Hyndburn 006","E02005217","Total",4185,2280,1387,893,13,882,244,638,937,856,2,69,10,73
"2011","Hyndburn 007","E02005218","Total",3387,2199,976,1223,6,532,144,388,603,536,3,58,6,47
"2011","Hyndburn 008","E02005219","Total",3770,2710,1353,1357,1,393,97,296,629,589,1,30,9,37
"2011","Hyndburn 009","E02005220","Total",2766,2290,1181,1109,8,184,76,108,256,228,0,26,2,28
"2011","Lancaster 001","E02005221","Total",4379,3518,1932,1586,26,291,251,40,490,424,8,51,7,54
"2011","Lancaster 002","E02005222","Total",2565,2032,1335,697,12,105,82,23,340,278,15,41,6,76
"2011","Lancaster 003","E02005223","Total",3164,2830,1743,1087,4,73,60,13,235,214,1,18,2,22
"2011","Lancaster 004","E02005224","Total",2570,2078,1402,676,9,29,3,26,423,393,2,25,3,31
"2011","Lancaster 005","E02005225","Total",2310,1870,1115,755,13,174,135,39,223,185,11,23,4,30
"2011","Lancaster 006","E02005226","Total",3576,1657,764,893,57,491,21,470,1326,1245,9,59,13,45
"2011","Lancaster 008","E02005228","Total",2422,1895,867,1028,9,54,28,26,444,396,2,45,1,20
"2011","Lancaster 009","E02005229","Total",2636,1125,521,604,52,168,15,153,1268,1222,5,37,4,23
"2011","Lancaster 010","E02005230","Total",3059,2014,1125,889,10,579,414,165,418,369,1,42,6,38
"2011","Lancaster 011","E02005231","Total",3605,2084,785,1299,39,906,760,146,512,445,1,61,5,64
"2011","Lancaster 013","E02005233","Total",2421,1673,683,990,9,389,369,20,318,288,0,28,2,32
"2011","Lancaster 014","E02005234","Total",3377,1311,639,672,36,454,175,279,1523,1415,5,54,49,53
"2011","Lancaster 015","E02005235","Total",2105,1155,531,624,7,105,22,83,818,771,4,40,3,20
"2011","Lancaster 016","E02005236","Total",5512,4288,2057,2231,17,420,315,105,719,615,4,97,3,68
"2011","Lancaster 017","E02005237","Total",3933,2652,1263,1389,38,502,351,151,704,638,4,56,6,37
"2011","Lancaster 018","E02005238","Total",2459,1765,901,864,3,319,215,104,344,304,1,35,4,28
"2011","Lancaster 019","E02005239","Total",2571,2041,1158,883,17,65,52,13,385,336,12,30,7,63
"2011","Lancaster 020","E02006871","Total",5158,4011,2069,1942,9,638,361,277,439,377,2,54,6,61
"2011","Pendle 001","E02005240","Total",2366,1725,804,921,6,216,92,124,392,353,4,32,3,27
"2011","Pendle 002","E02005241","Total",2499,1841,937,904,1,111,51,60,511,475,1,31,4,35
"2011","Pendle 003","E02005242","Total",2678,2003,1059,944,6,242,118,124,395,363,3,28,1,32
"2011","Pendle 004","E02005243","Total",2462,1459,728,731,7,448,264,184,501,460,0,35,6,47
"2011","Pendle 005","E02005244","Total",2413,1455,678,777,2,579,322,257,346,318,0,27,1,31
"2011","Pendle 006","E02005245","Total",3016,2479,1240,1239,5,124,54,70,373,329,2,40,2,35
"2011","Pendle 007","E02005246","Total",2409,1327,631,696,7,388,127,261,656,610,4,38,4,31
"2011","Pendle 008","E02005247","Total",4459,3584,1858,1726,6,234,105,129,567,509,2,51,5,68
"2011","Pendle 009","E02005248","Total",2451,1246,777,469,9,536,310,226,604,554,2,44,4,56
"2011","Pendle 010","E02005249","Total",4058,2126,1170,956,13,697,276,421,1139,1075,6,50,8,83
"2011","Pendle 011","E02005250","Total",2627,1808,1121,687,2,192,89,103,560,513,2,38,7,65
"2011","Pendle 012","E02005251","Total",2629,1968,961,1007,5,366,217,149,248,209,1,32,6,42
"2011","Pendle 013","E02005252","Total",3281,2559,1471,1088,4,200,79,121,468,424,2,40,2,50
"2011","Preston 001","E02005253","Total",2293,2011,1086,925,17,27,8,19,209,171,1,29,8,29
"2011","Preston 002","E02005254","Total",2528,2265,1241,1024,6,71,12,59,140,115,3,19,3,46
"2011","Preston 003","E02005255","Total",3742,3285,1762,1523,20,120,1,119,288,256,2,27,3,29
"2011","Preston 004","E02005256","Total",2915,2350,907,1443,43,190,10,180,311,277,9,24,1,21
"2011","Preston 005","E02005257","Total",2776,1235,513,722,26,1249,168,1081,234,208,1,14,11,32
"2011","Preston 006","E02005258","Total",3299,2511,1418,1093,44,315,29,286,384,329,24,17,14,45
"2011","Preston 007","E02005259","Total",4099,2546,1118,1428,8,1136,317,819,326,280,1,31,14,83
"2011","Preston 008","E02005260","Total",2860,2518,1306,1212,14,82,26,56,224,199,1,22,2,22
"2011","Preston 009","E02005261","Total",4054,1846,685,1161,61,1768,629,1139,293,250,2,31,10,86
"2011","Preston 010","E02005262","Total",2682,1940,684,1256,7,211,17,194,501,473,2,21,5,23
"2011","Preston 011","E02005263","Total",2788,1411,626,785,15,404,42,362,924,863,2,53,6,34
"2011","Preston 012","E02005264","Total",5005,2652,1010,1642,14,549,64,485,1736,1611,10,99,16,54
"2011","Preston 013","E02005265","Total",4706,2925,1227,1698,29,1048,243,805,642,587,4,46,5,62
"2011","Preston 014","E02005266","Total",3295,1398,587,811,17,936,240,696,880,818,4,50,8,64
"2011","Preston 015","E02005267","Total",2188,705,408,297,8,827,136,691,591,551,3,21,16,57
"2011","Preston 016","E02005268","Total",3529,1945,1047,898,10,815,184,631,710,661,2,39,8,49
"2011","Preston 017","E02005269","Total",4808,1366,730,636,58,1313,133,1180,1972,1891,13,55,13,99
"2011","Ribble Valley 001","E02005270","Total",2944,2128,1324,804,23,120,10,110,607,510,49,30,18,66
"2011","Ribble Valley 002","E02005271","Total",3266,2381,1288,1093,15,285,37,248,538,487,9,40,2,47
"2011","Ribble Valley 003","E02005272","Total",3295,2174,1156,1018,21,648,165,483,389,335,1,47,6,63
"2011","Ribble Valley 004","E02005273","Total",2381,1890,1096,794,7,119,22,97,320,277,7,23,13,45
"2011","Ribble Valley 005","E02005274","Total",2842,2223,1213,1010,7,174,27,147,405,367,7,26,5,33
"2011","Ribble Valley 006","E02005275","Total",2291,1698,876,822,12,205,47,158,363,321,3,37,2,13
"2011","Ribble Valley 007","E02005276","Total",3332,2696,1330,1366,35,172,27,145,385,316,25,34,10,44
"2011","Ribble Valley 008","E02005277","Total",3694,3233,1803,1430,25,113,30,83,271,217,8,37,9,52
"2011","Rossendale 001","E02005278","Total",3162,2596,1054,1542,11,209,44,165,311,272,2,31,6,35
"2011","Rossendale 002","E02005279","Total",4263,2737,1283,1454,7,728,190,538,730,656,4,59,11,61
"2011","Rossendale 003","E02005280","Total",4281,2807,1174,1633,9,707,289,418,710,635,2,63,10,48
"2011","Rossendale 004","E02005281","Total",3503,2257,1065,1192,14,634,237,397,544,501,2,40,1,54
"2011","Rossendale 007","E02005284","Total",2405,1920,919,1001,13,236,71,165,210,174,0,34,2,26
"2011","Rossendale 008","E02005285","Total",2740,2249,1074,1175,15,144,40,104,299,266,3,26,4,33
"2011","Rossendale 009","E02005286","Total",3292,2273,1003,1270,5,509,185,324,469,415,2,50,2,36
"2011","Rossendale 010","E02006884","Total",5412,3411,1588,1823,13,1077,360,717,833,764,5,58,6,78
"2011","South Ribble 001","E02005287","Total",2158,1987,1003,984,4,33,2,31,117,101,4,9,3,17
"2011","South Ribble 002","E02005288","Total",2596,2216,1201,1015,4,148,13,135,200,184,1,12,3,28
"2011","South Ribble 003","E02005289","Total",2615,2392,1310,1082,6,22,0,22,178,154,0,21,3,17
"2011","South Ribble 004","E02005290","Total",2992,2616,1117,1499,7,61,7,54,290,257,3,28,2,18
"2011","South Ribble 005","E02005291","Total",2418,1931,900,1031,37,160,5,155,267,247,2,17,1,23
"2011","South Ribble 006","E02005292","Total",2664,1601,670,931,26,780,56,724,230,207,2,17,4,27
"2011","South Ribble 007","E02005293","Total",2521,1802,945,857,3,342,19,323,350,326,2,22,0,24
"2011","South Ribble 008","E02005294","Total",2589,1922,831,1091,29,306,24,282,306,266,5,32,3,26
"2011","South Ribble 009","E02005295","Total",3125,2654,1153,1501,12,130,10,120,311,264,4,40,3,18
"2011","South Ribble 010","E02005296","Total",2397,2141,1248,893,14,67,5,62,153,127,7,15,4,22
"2011","South Ribble 011","E02005297","Total",3481,3045,1677,1368,10,127,2,125,251,222,2,22,5,48
"2011","South Ribble 012","E02005298","Total",2955,2473,1100,1373,5,236,14,222,219,191,3,21,4,22
"2011","South Ribble 013","E02005299","Total",3076,2256,789,1467,5,305,24,281,492,451,4,32,5,18
"2011","South Ribble 014","E02005300","Total",2081,1604,621,983,6,331,13,318,124,114,2,8,0,16
"2011","South Ribble 015","E02005301","Total",2787,1874,863,1011,16,613,56,557,252,216,0,29,7,32
"2011","South Ribble 016","E02005302","Total",2946,2384,1149,1235,19,162,11,151,354,334,2,17,1,27
"2011","South Ribble 017","E02005303","Total",2701,1439,612,827,12,1022,92,930,214,184,0,27,3,14
"2011","West Lancashire 001","E02005304","Total",3493,2986,1477,1509,24,150,131,19,301,265,8,21,7,32
"2011","West Lancashire 002","E02005305","Total",3157,2613,1488,1125,26,195,116,79,277,228,11,32,6,46
"2011","West Lancashire 003","E02005306","Total",2971,2447,1398,1049,14,157,130,27,315,255,9,41,10,38
"2011","West Lancashire 004","E02005307","Total",3729,2848,1313,1535,13,425,283,142,398,355,1,35,7,45
"2011","West Lancashire 005","E02005308","Total",2766,2402,1372,1030,25,100,92,8,191,165,0,24,2,48
"2011","West Lancashire 006","E02005309","Total",3459,2874,1625,1249,18,239,221,18,295,269,1,21,4,33
"2011","West Lancashire 007","E02005310","Total",3036,1749,914,835,66,460,286,174,718,678,6,26,8,43
"2011","West Lancashire 008","E02005311","Total",2254,1896,1073,823,8,100,81,19,213,190,6,15,2,37
"2011","West Lancashire 009","E02005312","Total",2405,1810,618,1192,14,388,320,68,183,160,1,19,3,10
"2011","West Lancashire 010","E02005313","Total",3476,1768,530,1238,7,1282,1244,38,380,363,0,16,1,39
"2011","West Lancashire 011","E02005314","Total",2834,1743,692,1051,2,680,618,62,365,336,1,27,1,44
"2011","West Lancashire 012","E02005315","Total",3259,2878,1615,1263,29,135,124,11,178,159,0,18,1,39
"2011","West Lancashire 013","E02005316","Total",2518,1402,494,908,9,801,680,121,269,245,2,21,1,37
"2011","West Lancashire 014","E02005317","Total",2939,1326,511,815,4,1134,1054,80,426,391,2,30,3,49
"2011","West Lancashire 015","E02005318","Total",3085,2380,1152,1228,12,410,331,79,235,204,0,25,6,48
"2011","Wyre 001","E02005319","Total",3952,2271,1069,1202,11,417,44,373,1189,1111,2,72,4,64
"2011","Wyre 002","E02005320","Total",2369,1873,924,949,12,236,45,191,226,206,6,13,1,22
"2011","Wyre 003","E02005321","Total",2662,1734,1028,706,18,674,167,507,195,151,20,19,5,41
"2011","Wyre 004","E02005322","Total",4418,3682,2251,1431,31,164,9,155,491,424,5,55,7,50
"2011","Wyre 005","E02005323","Total",2873,1893,913,980,19,634,118,516,296,266,5,23,2,31
"2011","Wyre 006","E02005324","Total",2337,1809,1039,770,25,128,4,124,330,288,12,26,4,45
"2011","Wyre 007","E02005325","Total",4023,3282,2113,1169,45,231,29,202,413,372,4,32,5,52
"2011","Wyre 008","E02005326","Total",3961,2893,1711,1182,5,182,24,158,841,784,6,42,9,40
"2011","Wyre 009","E02005327","Total",2352,1976,1134,842,13,115,11,104,208,178,3,24,3,40
"2011","Wyre 010","E02005328","Total",3391,2952,1673,1279,13,31,1,30,369,327,0,40,2,26
"2011","Wyre 011","E02005329","Total",3910,2924,1355,1569,22,284,33,251,643,592,2,39,10,37
"2011","Wyre 012","E02005330","Total",3840,3438,1860,1578,16,39,2,37,318,291,2,23,2,29
"2011","Wyre 013","E02005331","Total",3578,2690,1464,1226,12,241,31,210,584,534,2,44,4,51
"2011","Wyre 014","E02005332","Total",3615,3259,1889,1370,4,25,4,21,294,267,2,23,2,33
"2011","Knowsley 001","E02001327","Total",2883,1270,392,878,11,1293,742,551,271,249,1,14,7,38
"2011","Knowsley 002","E02001328","Total",4090,3300,1085,2215,37,325,151,174,402,364,0,33,5,26
"2011","Knowsley 003","E02001329","Total",3422,1492,592,900,6,1458,688,770,404,386,0,11,7,62
"2011","Knowsley 004","E02001330","Total",3651,2219,852,1367,8,831,416,415,557,524,1,27,5,36
"2011","Knowsley 005","E02001331","Total",4260,2402,1125,1277,13,1290,591,699,474,437,4,27,6,81
"2011","Knowsley 006","E02001332","Total",3060,1188,456,732,29,1586,172,1414,214,200,0,11,3,43
"2011","Knowsley 007","E02001333","Total",3754,1863,809,1054,21,1314,652,662,487,443,3,31,10,69
"2011","Knowsley 008","E02001334","Total",2468,792,326,466,3,1488,827,661,130,122,0,7,1,55
"2011","Knowsley 009","E02001335","Total",3088,2394,1026,1368,6,314,151,163,350,321,1,28,0,24
"2011","Knowsley 010","E02001336","Total",2963,1099,458,641,2,1530,805,725,271,254,0,15,2,61
"2011","Knowsley 011","E02001337","Total",2403,1564,668,896,17,571,241,330,226,205,1,17,3,25
"2011","Knowsley 012","E02001338","Total",2466,1493,618,875,2,556,229,327,382,360,1,21,0,33
"2011","Knowsley 013","E02001339","Total",2771,1604,656,948,19,876,498,378,230,210,0,17,3,42
"2011","Knowsley 014","E02001340","Total",3641,3209,1586,1623,4,111,41,70,301,278,0,21,2,16
"2011","Knowsley 015","E02001341","Total",3033,1715,767,948,21,913,456,457,327,293,0,29,5,57
"2011","Knowsley 016","E02001342","Total",2874,2604,1329,1275,21,40,6,34,184,162,2,20,0,25
"2011","Knowsley 017","E02001343","Total",2878,2558,1189,1369,5,70,24,46,216,189,3,21,3,29
"2011","Knowsley 018","E02001344","Total",2231,1419,532,887,10,628,246,382,138,123,0,9,6,36
"2011","Knowsley 019","E02001345","Total",2302,2023,903,1120,52,64,17,47,151,132,0,18,1,12
"2011","Knowsley 020","E02001346","Total",3085,1688,663,1025,27,1075,526,549,265,236,0,28,1,30
"2011","Liverpool 001","E02001347","Total",3204,1875,690,1185,10,920,252,668,355,297,29,16,13,44
"2011","Liverpool 002","E02001348","Total",3148,2156,914,1242,3,182,21,161,769,725,1,41,2,38
"2011","Liverpool 003","E02001349","Total",3422,2382,955,1427,5,226,44,182,774,734,0,33,7,35
"2011","Liverpool 004","E02001350","Total",3417,1499,491,1008,29,1344,325,1019,475,446,1,20,8,70
"2011","Liverpool 005","E02001351","Total",3515,1494,583,911,3,1511,365,1146,464,431,0,20,13,43
"2011","Liverpool 006","E02001352","Total",3046,1259,508,751,2,924,162,762,815,778,2,27,8,46
"2011","Liverpool 007","E02001353","Total",2959,2368,672,1696,46,195,43,152,332,301,5,18,8,18
"2011","Liverpool 008","E02001354","Total",3312,1616,699,917,9,1276,376,900,357,337,0,12,8,54
"2011","Liverpool 009","E02001355","Total",3108,1583,711,872,16,726,85,641,744,699,0,31,14,39
"2011","Liverpool 010","E02001356","Total",2364,749,318,431,4,1338,331,1007,250,230,0,7,13,23
"2011","Liverpool 011","E02001357","Total",2858,1191,594,597,4,1409,400,1009,209,191,0,12,6,45
"2011","Liverpool 012","E02001358","Total",3450,1546,685,861,7,672,59,613,1186,1144,2,33,7,39
"2011","Liverpool 013","E02001359","Total",2328,1690,710,980,6,368,73,295,231,215,1,14,1,33
"2011","Liverpool 014","E02001360","Total",4130,1276,631,645,26,1977,466,1511,799,755,5,30,9,52
"2011","Liverpool 015","E02001361","Total",3388,1744,784,960,15,1045,161,884,531,486,0,36,9,53
"2011","Liverpool 016","E02001362","Total",3161,2071,986,1085,13,781,234,547,248,223,1,18,6,48
"2011","Liverpool 017","E02001363","Total",3481,1404,542,862,10,1504,359,1145,514,482,1,25,6,49
"2011","Liverpool 018","E02001364","Total",2532,772,399,373,12,1066,80,986,641,621,0,17,3,41
"2011","Liverpool 019","E02001365","Total",4059,1870,863,1007,10,505,40,465,1612,1558,2,38,14,62
"2011","Liverpool 020","E02001366","Total",4081,2162,921,1241,33,680,111,569,1163,1091,7,54,11,43
"2011","Liverpool 021","E02001367","Total",3939,3008,1483,1525,2,343,48,295,530,477,4,46,3,56
"2011","Liverpool 022","E02001368","Total",2918,634,256,378,48,1810,402,1408,367,338,2,15,12,59
"2011","Liverpool 023","E02001369","Total",3877,1003,468,535,27,2000,363,1637,786,740,1,32,13,61
"2011","Liverpool 024","E02001370","Total",3153,609,306,303,15,1882,250,1632,587,548,2,23,14,60
"2011","Liverpool 025","E02001371","Total",3076,1500,494,1006,4,1195,347,848,343,319,1,19,4,34
"2011","Liverpool 026","E02001372","Total",2728,1550,648,902,22,794,159,635,332,302,4,22,4,30
"2011","Liverpool 027","E02001373","Total",4089,2252,1012,1240,6,795,104,691,971,896,5,58,12,65
"2011","Liverpool 028","E02001374","Total",4105,1205,552,653,19,1177,106,1071,1636,1569,1,42,24,68
"2011","Liverpool 029","E02001375","Total",3202,1930,880,1050,5,641,120,521,573,537,2,27,7,53
"2011","Liverpool 030","E02001376","Total",3789,1165,634,531,16,1034,132,902,1493,1429,0,48,16,81
"2011","Liverpool 031","E02001377","Total",4063,772,446,326,22,1551,179,1372,1658,1563,8,39,48,60
"2011","Liverpool 032","E02001378","Total",3557,1862,774,1088,20,936,176,760,682,635,1,42,4,57
"2011","Liverpool 034","E02001380","Total",3117,2556,1213,1343,10,172,45,127,356,333,0,18,5,23
"2011","Liverpool 035","E02001381","Total",4312,1675,768,907,12,971,77,894,1604,1531,2,58,13,50
"2011","Liverpool 036","E02001382","Total",2782,2437,1064,1373,2,75,14,61,246,217,5,22,2,22
"2011","Liverpool 037","E02001383","Total",4260,329,145,184,57,2425,198,2227,1400,1225,13,27,135,49
"2011","Liverpool 038","E02001384","Total",3941,1295,637,658,39,618,46,572,1953,1856,5,77,15,36
"2011","Liverpool 039","E02001385","Total",3631,489,282,207,30,2147,323,1824,893,831,9,26,27,72
"2011","Liverpool 040","E02001386","Total",3572,1437,664,773,72,1771,265,1506,213,185,0,23,5,79
"2011","Liverpool 041","E02001387","Total",3162,2645,1264,1381,3,59,9,50,421,396,1,22,2,34
"2011","Liverpool 042","E02001388","Total",4170,1784,776,1008,11,410,52,358,1934,1327,4,72,531,31
"2011","Liverpool 043","E02001389","Total",3740,567,264,303,31,1358,92,1266,1740,1685,9,30,16,44
"2011","Liverpool 044","E02001390","Total",4094,839,409,430,65,2462,371,2091,637,569,0,31,37,91
"2011","Liverpool 045","E02001391","Total",2481,1193,528,665,32,1021,179,842,210,188,2,11,9,25
"2011","Liverpool 046","E02001392","Total",2556,2156,1259,897,13,86,8,78,273,240,5,27,1,28
"2011","Liverpool 047","E02001393","Total",2845,2574,1401,1173,3,53,9,44,194,173,1,16,4,21
"2011","Liverpool 048","E02001394","Total",4290,1787,795,992,12,1091,43,1048,1359,1269,15,60,15,41
"2011","Liverpool 049","E02001395","Total",2612,2103,991,1112,10,101,16,85,382,339,6,34,3,16
"2011","Liverpool 050","E02001396","Total",3918,1744,770,974,5,878,159,719,1250,1192,1,47,10,41
"2011","Liverpool 051","E02001397","Total",3848,2234,1159,1075,7,954,109,845,594,562,2,26,4,59
"2011","Liverpool 052","E02001398","Total",3595,1834,831,1003,14,752,36,716,962,910,0,47,5,33
"2011","Liverpool 053","E02001399","Total",2866,2450,1265,1185,2,215,10,205,180,167,2,10,1,19
"2011","Liverpool 054","E02001400","Total",2839,1779,813,966,4,752,197,555,255,226,1,23,5,49
"2011","Liverpool 055","E02001401","Total",3395,2548,1368,1180,15,318,45,273,483,454,4,22,3,31
"2011","Liverpool 056","E02001402","Total",3762,2707,1300,1407,11,318,40,278,694,633,1,50,10,32
"2011","Liverpool 057","E02001403","Total",2841,1262,495,767,31,802,108,694,719,682,0,29,8,27
"2011","Liverpool 058","E02001404","Total",3155,1375,562,813,4,1288,263,1025,457,425,3,23,6,31
"2011","Liverpool 059","E02001405","Total",4154,1371,585,786,13,2254,559,1695,463,432,0,20,11,53
"2011","Liverpool 060","E02006932","Total",3201,326,126,200,97,584,58,526,2168,2061,7,37,63,26
"2011","Liverpool 061","E02006933","Total",3135,742,308,434,8,575,142,433,1765,1701,2,42,20,45
"2011","Liverpool 062","E02006934","Total",2782,512,152,360,14,168,22,146,2058,2006,6,34,12,30
"2011","Sefton 001","E02001429","Total",3059,2643,1524,1119,11,107,28,79,277,234,0,39,4,21
"2011","Sefton 002","E02001430","Total",3011,2585,1451,1134,2,78,17,61,319,281,1,34,3,27
"2011","Sefton 003","E02001431","Total",3639,2467,1577,890,29,537,70,467,557,521,2,27,7,49
"2011","Sefton 004","E02001432","Total",4486,1803,1085,718,95,367,12,355,2167,2087,12,59,9,54
"2011","Sefton 005","E02001433","Total",3140,2262,982,1280,6,293,48,245,551,495,2,51,3,28
"2011","Sefton 006","E02001434","Total",2868,2165,883,1282,23,162,6,156,479,430,2,46,1,39
"2011","Sefton 007","E02001435","Total",3411,2094,965,1129,26,89,8,81,1157,1098,5,50,4,45
"2011","Sefton 008","E02001436","Total",3558,2711,1275,1436,22,272,15,257,522,460,2,54,6,31
"2011","Sefton 009","E02001437","Total",4309,3306,2068,1238,48,218,3,215,688,649,3,34,2,49
"2011","Sefton 010","E02001438","Total",3065,2554,1204,1350,5,155,48,107,328,290,2,33,3,23
"2011","Sefton 011","E02001439","Total",2733,1887,952,935,21,507,145,362,272,240,3,26,3,46
"2011","Sefton 012","E02001440","Total",2600,2436,1594,842,10,13,7,6,122,98,8,11,5,19
"2011","Sefton 013","E02001441","Total",2688,2531,1592,939,2,23,1,22,113,94,5,11,3,19
"2011","Sefton 014","E02001442","Total",2609,2167,1288,879,19,162,38,124,229,206,4,16,3,32
"2011","Sefton 015","E02001443","Total",2279,2105,1255,850,2,62,18,44,96,82,0,12,2,14
"2011","Sefton 016","E02001444","Total",2397,2109,1176,933,4,44,17,27,220,190,10,16,4,20
"2011","Sefton 017","E02001445","Total",2942,2638,1412,1226,3,95,40,55,186,166,0,19,1,20
"2011","Sefton 018","E02001446","Total",2855,2589,1478,1111,3,75,13,62,171,139,1,28,3,17
"2011","Sefton 019","E02001447","Total",2555,2115,1178,937,28,201,54,147,175,162,0,13,0,36
"2011","Sefton 020","E02001448","Total",2789,2512,1298,1214,1,84,18,66,172,149,2,19,2,20
"2011","Sefton 021","E02001449","Total",3865,3031,1559,1472,2,521,238,283,259,228,0,25,6,52
"2011","Sefton 022","E02001450","Total",3523,2989,1636,1353,4,87,8,79,407,372,0,32,3,36
"2011","Sefton 023","E02001451","Total",2623,1509,685,824,17,855,436,419,199,183,0,15,1,43
"2011","Sefton 024","E02001452","Total",2871,1258,541,717,9,1370,652,718,182,157,1,16,8,52
"2011","Sefton 025","E02001453","Total",3498,3014,1451,1563,4,229,30,199,220,202,0,17,1,31
"2011","Sefton 026","E02001454","Total",2912,2518,1248,1270,2,165,66,99,203,173,4,23,3,24
"2011","Sefton 027","E02001455","Total",2913,2496,1151,1345,6,182,33,149,204,183,3,15,3,25
"2011","Sefton 028","E02001456","Total",3254,2411,1107,1304,6,212,21,191,588,547,5,34,2,37
"2011","Sefton 029","E02001457","Total",2980,1431,587,844,56,1251,497,754,196,172,0,23,1,46
"2011","Sefton 030","E02001458","Total",3211,2288,896,1392,8,216,43,173,677,636,1,36,4,22
"2011","Sefton 031","E02001459","Total",2928,1862,778,1084,5,646,315,331,389,369,0,17,3,26
"2011","Sefton 032","E02001460","Total",3696,1612,722,890,26,1440,349,1091,576,540,0,27,9,42
"2011","Sefton 033","E02001461","Total",2646,2021,895,1126,30,389,167,222,179,156,2,20,1,27
"2011","Sefton 034","E02001462","Total",3406,1219,464,755,21,1553,261,1292,573,537,1,29,6,40
"2011","Sefton 035","E02001463","Total",2727,1480,586,894,3,1005,472,533,202,180,0,20,2,37
"2011","Sefton 036","E02001464","Total",3102,1364,547,817,34,872,95,777,803,764,0,30,9,29
"2011","Sefton 037","E02001465","Total",3205,881,388,493,56,1676,406,1270,550,521,2,18,9,42
"2011","Sefton 038","E02001466","Total",3577,2074,856,1218,15,850,216,634,596,561,3,24,8,42
"2011","St. Helens 001","E02001406","Total",3445,2962,1807,1155,10,219,60,159,211,182,6,16,7,43
"2011","St. Helens 002","E02001407","Total",2617,2224,1300,924,4,237,56,181,118,107,0,9,2,34
"2011","St. Helens 003","E02001408","Total",2368,2044,1052,992,0,165,76,89,131,111,3,16,1,28
"2011","St. Helens 004","E02001409","Total",4325,2895,1450,1445,9,1104,311,793,253,220,2,25,6,64
"2011","St. Helens 005","E02001410","Total",2498,1634,778,856,2,610,215,395,212,188,0,19,5,40
"2011","St. Helens 006","E02001411","Total",2520,1827,873,954,32,375,106,269,251,220,0,25,6,35
"2011","St. Helens 007","E02001412","Total",3686,2725,1387,1338,9,575,155,420,327,288,3,32,4,50
"2011","St. Helens 008","E02001413","Total",4085,3039,1572,1467,11,736,249,487,251,215,0,30,6,48
"2011","St. Helens 009","E02001414","Total",2253,2098,1260,838,12,32,13,19,87,75,1,10,1,24
"2011","St. Helens 010","E02001415","Total",2737,1638,638,1000,13,795,266,529,246,222,0,21,3,45
"2011","St. Helens 011","E02001416","Total",2540,1208,545,663,10,970,343,627,310,282,2,19,7,42
"2011","St. Helens 012","E02001417","Total",3623,1642,659,983,45,1178,226,952,690,659,2,19,10,68
"2011","St. Helens 013","E02001418","Total",2487,1286,524,762,54,719,187,532,391,355,3,27,6,37
"2011","St. Helens 014","E02001419","Total",3188,1383,657,726,19,972,271,701,754,714,2,28,10,60
"2011","St. Helens 015","E02001420","Total",4348,2713,1191,1522,45,1110,271,839,421,397,1,18,5,59
"2011","St. Helens 016","E02001421","Total",4658,3250,1521,1729,31,619,163,456,698,652,1,41,4,60
"2011","St. Helens 017","E02001422","Total",2651,1171,487,684,14,988,412,576,431,403,0,25,3,47
"2011","St. Helens 018","E02001423","Total",2657,2126,1092,1034,5,298,87,211,195,185,0,9,1,33
"2011","St. Helens 019","E02001424","Total",5700,3294,1398,1896,56,1695,539,1156,573,516,2,41,14,82
"2011","St. Helens 020","E02001425","Total",4523,3229,1632,1597,10,835,197,638,399,358,3,37,1,50
"2011","St. Helens 021","E02001426","Total",2299,1894,1029,865,4,163,29,134,216,194,0,20,2,22
"2011","St. Helens 022","E02001427","Total",4276,2632,1163,1469,27,1127,345,782,452,407,4,35,6,38
"2011","St. Helens 023","E02001428","Total",2252,2038,1200,838,5,75,13,62,119,106,0,13,0,15
"2011","Wirral 001","E02001467","Total",3732,2187,1075,1112,15,355,25,330,1143,1086,5,45,7,32
"2011","Wirral 002","E02001468","Total",3346,2130,870,1260,15,205,29,176,959,894,2,53,10,37
"2011","Wirral 003","E02001469","Total",3465,2671,1397,1274,16,231,63,168,517,468,3,41,5,30
"2011","Wirral 004","E02001470","Total",3456,2943,1447,1496,4,37,11,26,441,398,2,40,1,31
"2011","Wirral 005","E02001471","Total",3301,1765,696,1069,22,438,106,332,1043,975,0,59,9,33
"2011","Wirral 006","E02001472","Total",2969,2069,921,1148,11,519,84,435,336,305,1,28,2,34
"2011","Wirral 007","E02001473","Total",3352,2407,1163,1244,9,197,79,118,707,660,2,41,4,32
"2011","Wirral 008","E02001474","Total",3248,1217,529,688,5,1042,251,791,955,912,1,31,11,29
"2011","Wirral 009","E02001475","Total",2777,1255,523,732,4,1205,431,774,267,240,1,20,6,46
"2011","Wirral 010","E02001476","Total",3419,1550,640,910,13,860,342,518,978,920,1,48,9,18
"2011","Wirral 011","E02001477","Total",3296,873,313,560,2,1942,1019,923,449,431,1,10,7,30
"2011","Wirral 012","E02001478","Total",3507,2455,1291,1164,6,618,293,325,376,336,1,31,8,52
"2011","Wirral 013","E02001479","Total",2512,2242,1022,1220,7,49,18,31,198,170,1,21,6,16
"2011","Wirral 014","E02001480","Total",3326,2604,1326,1278,10,133,56,77,553,486,7,54,6,26
"2011","Wirral 015","E02001481","Total",3450,2580,1179,1401,15,178,75,103,644,597,0,45,2,33
"2011","Wirral 016","E02001482","Total",4206,860,390,470,49,2222,426,1796,1038,988,3,33,14,37
"2011","Wirral 017","E02001483","Total",3202,2756,1296,1460,16,105,51,54,298,259,1,37,1,27
"2011","Wirral 018","E02001484","Total",3368,2604,1311,1293,28,365,163,202,334,295,3,34,2,37
"2011","Wirral 019","E02001485","Total",2610,1346,583,763,27,905,446,459,280,261,0,16,3,52
"2011","Wirral 020","E02001486","Total",4169,2475,1290,1185,44,565,33,532,1050,1000,4,43,3,35
"2011","Wirral 021","E02001487","Total",4321,1784,712,1072,85,984,138,846,1427,1356,2,62,7,41
"2011","Wirral 022","E02001488","Total",3843,2391,981,1410,21,369,78,291,1020,946,4,64,6,42
"2011","Wirral 023","E02001489","Total",3587,3242,1810,1432,19,90,20,70,206,181,1,23,1,30
"2011","Wirral 024","E02001490","Total",3451,3018,1373,1645,10,84,52,32,320,289,1,26,4,19
"2011","Wirral 025","E02001491","Total",3101,1464,661,803,20,1149,631,518,409,369,1,32,7,59
"2011","Wirral 026","E02001492","Total",3539,2559,1403,1156,18,282,94,188,628,576,5,44,3,52
"2011","Wirral 027","E02001493","Total",3727,1223,492,731,36,1416,447,969,1008,972,1,29,6,44
"2011","Wirral 028","E02001494","Total",2990,2724,1591,1133,5,68,17,51,171,158,0,11,2,22
"2011","Wirral 029","E02001495","Total",3370,2251,1031,1220,70,498,220,278,517,480,1,33,3,34
"2011","Wirral 030","E02001496","Total",2470,2004,1037,967,0,284,133,151,161,144,0,16,1,21
"2011","Wirral 031","E02001497","Total",3663,1782,783,999,18,1135,401,734,678,633,8,29,8,50
"2011","Wirral 032","E02001498","Total",3108,2502,1256,1246,5,255,122,133,312,282,1,26,3,34
"2011","Wirral 033","E02001499","Total",2941,2588,1489,1099,20,81,29,52,220,188,0,26,6,32
"2011","Wirral 034","E02001500","Total",3234,2808,1471,1337,8,184,48,136,207,182,1,22,2,27
"2011","Wirral 035","E02001501","Total",3259,2688,1343,1345,4,281,114,167,256,225,0,28,3,30
"2011","Wirral 036","E02001502","Total",3665,2535,1134,1401,6,534,101,433,545,494,2,44,5,45
"2011","Wirral 037","E02001503","Total",3434,2629,1485,1144,2,400,137,263,372,346,2,20,4,31
"2011","Wirral 038","E02001504","Total",3066,2696,1611,1085,11,20,2,18,289,262,7,13,7,50
"2011","Wirral 039","E02001505","Total",2747,1986,973,1013,3,445,191,254,291,274,0,16,1,22
"2011","Wirral 040","E02001506","Total",3821,3608,2235,1373,12,9,3,6,171,157,2,11,1,21
"2011","Wirral 041","E02001507","Total",3009,2776,1458,1318,6,53,10,43,158,141,1,15,1,16
"2011","Wirral 042","E02001508","Total",3526,2596,1215,1381,16,537,277,260,343,300,3,31,9,34
"2011","East Riding of Yorkshire 001","E02002684","Total",4628,3863,2520,1343,19,159,62,97,549,489,2,55,3,38
"2011","East Riding of Yorkshire 002","E02002685","Total",3739,3035,2021,1014,8,179,115,64,472,404,5,59,4,45
"2011","East Riding of Yorkshire 003","E02002686","Total",3571,1498,721,777,17,1430,1285,145,524,466,2,48,8,102
"2011","East Riding of Yorkshire 004","E02002687","Total",2759,1541,878,663,32,189,71,118,957,914,4,34,5,40
"2011","East Riding of Yorkshire 005","E02002688","Total",2523,1235,739,496,7,128,11,117,1121,1075,8,32,6,32
"2011","East Riding of Yorkshire 006","E02002689","Total",2511,1812,1089,723,9,196,155,41,424,372,10,40,2,70
"2011","East Riding of Yorkshire 008","E02002691","Total",3485,2687,1464,1223,4,211,178,33,483,405,33,36,9,100
"2011","East Riding of Yorkshire 009","E02002692","Total",3384,2877,1450,1427,16,176,146,30,274,250,4,13,7,41
"2011","East Riding of Yorkshire 010","E02002693","Total",2954,2298,1237,1061,1,224,170,54,371,325,13,25,8,60
"2011","East Riding of Yorkshire 011","E02002694","Total",4737,3321,1715,1606,9,452,374,78,800,742,19,34,5,155
"2011","East Riding of Yorkshire 012","E02002695","Total",3626,2674,1588,1086,8,375,245,130,518,469,7,39,3,51
"2011","East Riding of Yorkshire 013","E02002696","Total",2427,1849,984,865,2,99,70,29,420,327,49,14,30,57
"2011","East Riding of Yorkshire 014","E02002697","Total",3232,2684,1435,1249,11,156,110,46,340,292,7,25,16,41
"2011","East Riding of Yorkshire 015","E02002698","Total",3253,2455,1168,1287,13,315,245,70,424,384,4,27,9,46
"2011","East Riding of Yorkshire 016","E02002699","Total",3977,3570,1846,1724,9,83,38,45,275,243,3,28,1,40
"2011","East Riding of Yorkshire 017","E02002700","Total",2758,1343,589,754,23,1045,959,86,288,250,4,31,3,59
"2011","East Riding of Yorkshire 018","E02002701","Total",3456,2850,1443,1407,15,194,121,73,321,275,10,32,4,76
"2011","East Riding of Yorkshire 019","E02002702","Total",4798,3021,1521,1500,32,563,298,265,1099,1022,5,58,14,83
"2011","East Riding of Yorkshire 020","E02002703","Total",3663,3093,1426,1667,12,183,125,58,331,278,11,34,8,44
"2011","East Riding of Yorkshire 021","E02002704","Total",3089,2613,1459,1154,5,150,133,17,263,226,3,27,7,58
"2011","East Riding of Yorkshire 022","E02002705","Total",2765,2366,1441,925,2,195,169,26,170,147,6,12,5,32
"2011","East Riding of Yorkshire 023","E02002706","Total",3010,2469,1292,1177,5,217,207,10,299,274,2,20,3,20
"2011","East Riding of Yorkshire 024","E02002707","Total",2881,2471,1278,1193,6,123,110,13,244,214,6,17,7,37
"2011","East Riding of Yorkshire 025","E02002708","Total",2886,2053,1244,809,9,436,404,32,337,301,3,29,4,51
"2011","East Riding of Yorkshire 026","E02002709","Total",3203,2547,1249,1298,13,261,175,86,332,285,11,34,2,50
"2011","East Riding of Yorkshire 027","E02002710","Total",3106,2624,1259,1365,2,183,168,15,263,251,2,9,1,34
"2011","East Riding of Yorkshire 028","E02002711","Total",3172,2957,1714,1243,3,25,20,5,164,144,0,16,4,23
"2011","East Riding of Yorkshire 029","E02002712","Total",3257,2599,1301,1298,5,172,153,19,443,398,2,37,6,38
"2011","East Riding of Yorkshire 031","E02002714","Total",3264,2596,1350,1246,6,197,179,18,397,336,7,40,14,68
"2011","East Riding of Yorkshire 032","E02002715","Total",5106,4205,1634,2571,14,193,176,17,636,596,4,33,3,58
"2011","East Riding of Yorkshire 033","E02002716","Total",3604,2900,1320,1580,6,293,193,100,353,314,1,36,2,52
"2011","East Riding of Yorkshire 034","E02002717","Total",3460,2249,995,1254,11,546,470,76,616,566,4,45,1,38
"2011","East Riding of Yorkshire 035","E02002718","Total",3283,2905,1576,1329,5,106,76,30,238,225,0,13,0,29
"2011","East Riding of Yorkshire 036","E02002719","Total",2363,1942,946,996,5,146,131,15,252,234,3,13,2,18
"2011","East Riding of Yorkshire 037","E02002720","Total",2900,2496,1228,1268,2,48,47,1,330,301,4,20,5,24
"2011","East Riding of Yorkshire 038","E02002721","Total",2739,1936,956,980,17,410,289,121,322,299,2,18,3,54
"2011","East Riding of Yorkshire 039","E02002722","Total",3766,2319,1290,1029,10,681,595,86,670,592,14,53,11,86
"2011","East Riding of Yorkshire 040","E02002723","Total",3559,2347,1241,1106,9,282,206,76,869,822,6,36,5,52
"2011","East Riding of Yorkshire 041","E02002724","Total",3811,1989,868,1121,8,964,893,71,781,738,5,34,4,69
"2011","East Riding of Yorkshire 042","E02002725","Total",2740,2142,1023,1119,13,296,255,41,250,231,2,15,2,39
"2011","East Riding of Yorkshire 043","E02006814","Total",3517,2792,1327,1465,12,269,258,11,418,372,2,38,6,26
"2011","East Riding of Yorkshire 044","E02006891","Total",3114,2554,1296,1258,9,141,78,63,371,332,4,31,4,39
"2011","East Riding of Yorkshire 045","E02006892","Total",2956,1929,1019,910,9,337,290,47,639,580,5,46,8,42
"2011","Kingston upon Hull 001","E02002652","Total",4196,2632,465,2167,8,1004,300,704,523,470,1,39,13,29
"2011","Kingston upon Hull 002","E02002653","Total",3431,1158,443,715,8,1968,1802,166,244,218,0,19,7,53
"2011","Kingston upon Hull 003","E02002654","Total",3123,742,308,434,2,2092,1860,232,200,185,0,13,2,87
"2011","Kingston upon Hull 004","E02002655","Total",3594,1486,435,1051,8,1659,1619,40,380,345,1,33,1,61
"2011","Kingston upon Hull 005","E02002656","Total",2562,2191,1187,1004,7,21,10,11,333,302,2,27,2,10
"2011","Kingston upon Hull 006","E02002657","Total",3106,2494,1096,1398,6,300,247,53,272,241,1,29,1,34
"2011","Kingston upon Hull 007","E02002658","Total",2992,2223,898,1325,9,345,259,86,357,320,4,27,6,58
"2011","Kingston upon Hull 008","E02002659","Total",4665,1353,519,834,9,2756,2044,712,444,404,0,28,12,103
"2011","Kingston upon Hull 009","E02002660","Total",3154,1669,854,815,6,1193,1140,53,220,193,0,23,4,66
"2011","Kingston upon Hull 010","E02002661","Total",3373,1819,756,1063,4,1250,1204,46,231,205,2,20,4,69
"2011","Kingston upon Hull 011","E02002662","Total",3355,1677,706,971,31,1345,1000,345,222,190,0,26,6,80
"2011","Kingston upon Hull 012","E02002663","Total",2457,1409,620,789,3,206,22,184,827,615,1,32,179,12
"2011","Kingston upon Hull 013","E02002664","Total",3007,2673,1206,1467,11,63,60,3,237,212,0,23,2,23
"2011","Kingston upon Hull 014","E02002665","Total",3384,2475,1086,1389,19,363,212,151,489,444,2,38,5,38
"2011","Kingston upon Hull 015","E02002666","Total",3653,909,401,508,31,557,196,361,2119,2037,9,54,19,37
"2011","Kingston upon Hull 016","E02002667","Total",3295,2240,910,1330,3,170,131,39,853,812,1,35,5,29
"2011","Kingston upon Hull 017","E02002668","Total",3928,863,320,543,39,2695,1830,865,245,220,1,23,1,86
"2011","Kingston upon Hull 018","E02002669","Total",3699,1674,698,976,17,175,28,147,1811,1742,3,55,11,22
"2011","Kingston upon Hull 019","E02002670","Total",3688,1930,730,1200,14,1246,970,276,426,393,1,32,0,72
"2011","Kingston upon Hull 020","E02002671","Total",3246,2012,763,1249,28,672,536,136,502,453,2,46,1,32
"2011","Kingston upon Hull 021","E02002672","Total",3003,1097,433,664,20,1519,1226,293,322,294,1,23,4,45
"2011","Kingston upon Hull 022","E02002673","Total",3431,2186,838,1348,7,223,125,98,989,930,3,50,6,26
"2011","Kingston upon Hull 023","E02002674","Total",3251,2265,904,1361,6,197,180,17,758,720,0,36,2,25
"2011","Kingston upon Hull 024","E02002675","Total",4105,872,337,535,19,1742,1267,475,1380,1315,10,36,19,92
"2011","Kingston upon Hull 025","E02002676","Total",3523,1987,815,1172,6,248,211,37,1233,1144,1,79,9,49
"2011","Kingston upon Hull 026","E02002677","Total",4273,1891,608,1283,10,883,504,379,1427,1354,3,61,9,62
"2011","Kingston upon Hull 027","E02002678","Total",3349,2144,841,1303,19,127,63,64,1033,987,3,39,4,26
"2011","Kingston upon Hull 028","E02002679","Total",3227,2198,954,1244,7,653,523,130,335,300,1,29,5,34
"2011","Kingston upon Hull 029","E02002680","Total",5316,774,312,462,33,2550,1698,852,1816,1737,5,48,26,143
"2011","Kingston upon Hull 030","E02002681","Total",3905,1206,515,691,21,852,598,254,1770,1717,4,39,10,56
"2011","Kingston upon Hull 031","E02002682","Total",3514,1490,508,982,12,1278,920,358,675,639,0,32,4,59
"2011","Kingston upon Hull 033","E02006813","Total",3791,2046,889,1157,82,1282,1053,229,311,276,1,31,3,70
"2011","North East Lincolnshire 001","E02002726","Total",4427,2940,1366,1574,5,919,329,590,526,476,2,44,4,37
"2011","North East Lincolnshire 002","E02002727","Total",3297,566,228,338,16,1990,610,1380,670,625,2,19,24,55
"2011","North East Lincolnshire 003","E02002728","Total",3681,1748,693,1055,4,491,143,348,1396,1329,3,56,8,42
"2011","North East Lincolnshire 004","E02002729","Total",2578,1734,676,1058,15,570,226,344,235,211,2,20,2,24
"2011","North East Lincolnshire 005","E02002730","Total",3203,1664,626,1038,7,169,25,144,1342,1275,2,61,4,21
"2011","North East Lincolnshire 006","E02002731","Total",2497,1209,476,733,8,328,98,230,933,883,2,44,4,19
"2011","North East Lincolnshire 007","E02002732","Total",3093,2634,1218,1416,4,160,49,111,262,237,3,19,3,33
"2011","North East Lincolnshire 008","E02002733","Total",2802,1776,763,1013,3,293,40,253,702,644,6,50,2,28
"2011","North East Lincolnshire 009","E02002734","Total",2233,1630,734,896,12,258,101,157,321,288,0,31,2,12
"2011","North East Lincolnshire 010","E02002735","Total",2281,1489,601,888,1,81,13,68,681,632,4,41,4,29
"2011","North East Lincolnshire 011","E02002736","Total",2451,1222,460,762,8,198,28,170,1003,948,2,49,4,20
"2011","North East Lincolnshire 012","E02002737","Total",3098,2475,1098,1377,17,184,76,108,398,356,2,36,4,24
"2011","North East Lincolnshire 013","E02002738","Total",3024,2406,1018,1388,6,275,143,132,318,283,3,28,4,19
"2011","North East Lincolnshire 014","E02002739","Total",2876,1761,795,966,1,407,115,292,663,618,1,42,2,44
"2011","North East Lincolnshire 015","E02002740","Total",2438,1437,694,743,10,687,268,419,269,237,1,27,4,35
"2011","North East Lincolnshire 016","E02002741","Total",3693,2741,1266,1475,7,137,42,95,756,646,42,41,27,52
"2011","North East Lincolnshire 017","E02002742","Total",2494,1938,1062,876,5,43,8,35,489,453,3,30,3,19
"2011","North East Lincolnshire 018","E02002743","Total",2665,1705,959,746,17,694,204,490,214,191,0,21,2,35
"2011","North East Lincolnshire 019","E02002744","Total",2837,1064,420,644,9,1442,597,845,292,278,0,12,2,30
"2011","North East Lincolnshire 020","E02002745","Total",3406,2994,1731,1263,14,107,25,82,261,207,9,30,15,30
"2011","North East Lincolnshire 021","E02002746","Total",3779,3056,1482,1574,32,312,75,237,341,289,6,44,2,38
"2011","North East Lincolnshire 022","E02002747","Total",3409,3041,1604,1437,6,108,21,87,235,208,3,22,2,19
"2011","North East Lincolnshire 023","E02002748","Total",3445,2840,1527,1313,6,238,57,181,320,280,8,25,7,41
"2011","North Lincolnshire 001","E02002749","Total",4816,3377,1629,1748,17,669,288,381,697,625,7,53,12,56
"2011","North Lincolnshire 002","E02002750","Total",2636,2071,957,1114,5,210,75,135,311,293,1,14,3,39
"2011","North Lincolnshire 003","E02002751","Total",2667,1995,988,1007,5,342,139,203,295,246,6,37,6,30
"2011","North Lincolnshire 004","E02002752","Total",2935,2140,974,1166,3,350,134,216,408,352,14,38,4,34
"2011","North Lincolnshire 005","E02002753","Total",3956,2983,1591,1392,12,347,113,234,553,509,8,29,7,61
"2011","North Lincolnshire 006","E02002754","Total",3465,2551,1098,1453,13,457,212,245,404,358,4,35,7,40
"2011","North Lincolnshire 007","E02002755","Total",2907,1599,638,961,8,695,261,434,568,530,3,25,10,37
"2011","North Lincolnshire 008","E02002756","Total",3277,1150,499,651,14,1011,514,497,1042,996,6,32,8,60
"2011","North Lincolnshire 009","E02002757","Total",2518,1962,990,972,2,148,71,77,388,341,14,24,9,18
"2011","North Lincolnshire 010","E02002758","Total",2715,1628,657,971,8,608,238,370,436,405,3,26,2,35
"2011","North Lincolnshire 011","E02002759","Total",4151,2890,1502,1388,8,579,199,380,602,536,12,49,5,72
"2011","North Lincolnshire 012","E02002760","Total",2493,1761,822,939,3,511,234,277,185,162,2,16,5,33
"2011","North Lincolnshire 013","E02002761","Total",2834,2175,1000,1175,5,215,67,148,398,352,8,34,4,41
"2011","North Lincolnshire 014","E02002762","Total",2879,1696,706,990,6,773,369,404,361,322,1,33,5,43
"2011","North Lincolnshire 015","E02002763","Total",3164,1623,569,1054,7,1078,521,557,397,340,1,51,5,59
"2011","North Lincolnshire 016","E02002764","Total",2289,1152,518,634,7,894,514,380,199,181,1,15,2,37
"2011","North Lincolnshire 017","E02002765","Total",2711,1746,819,927,0,545,260,285,392,340,4,46,2,28
"2011","North Lincolnshire 018","E02002766","Total",3804,2967,1418,1549,15,366,183,183,414,383,0,29,2,42
"2011","North Lincolnshire 019","E02002767","Total",2967,2619,1320,1299,8,59,14,45,260,238,0,21,1,21
"2011","North Lincolnshire 020","E02002768","Total",3095,2454,1224,1230,13,292,129,163,288,254,5,26,3,48
"2011","North Lincolnshire 021","E02002769","Total",2539,2053,1121,932,5,185,74,111,236,203,11,19,3,60
"2011","North Lincolnshire 022","E02002770","Total",2899,2094,1038,1056,9,308,126,182,443,357,51,19,16,45
"2011","North Lincolnshire 023","E02002771","Total",2967,2451,1277,1174,6,253,117,136,200,170,7,21,2,57
"2011","York 001","E02002772","Total",2673,2145,959,1186,8,164,19,145,338,183,81,15,59,18
"2011","York 002","E02002773","Total",2624,2223,1288,935,10,211,26,185,152,134,1,15,2,28
"2011","York 003","E02002774","Total",2646,2420,1308,1112,7,27,11,16,165,145,3,17,0,27
"2011","York 004","E02002775","Total",2565,1505,956,549,106,816,29,787,122,108,1,9,4,16
"2011","York 005","E02002776","Total",2864,2310,1298,1012,38,260,16,244,241,213,3,23,2,15
"2011","York 006","E02002777","Total",3451,2699,1065,1634,14,360,35,325,348,320,2,24,2,30
"2011","York 007","E02002778","Total",3619,2810,1488,1322,14,179,53,126,579,546,0,28,5,37
"2011","York 008","E02002779","Total",4177,3228,1897,1331,13,401,310,91,485,441,3,37,4,50
"2011","York 009","E02002780","Total",3493,1618,686,932,26,998,795,203,802,743,4,44,11,49
"2011","York 010","E02002781","Total",4161,1800,809,991,57,833,642,191,1413,1356,3,46,8,58
"2011","York 011","E02002782","Total",2491,2133,1244,889,17,125,96,29,178,148,9,18,3,38
"2011","York 012","E02002783","Total",4152,3154,1442,1712,41,544,383,161,376,337,3,30,6,37
"2011","York 013","E02002784","Total",5511,1576,849,727,59,1418,982,436,2317,2189,17,51,60,141
"2011","York 014","E02002785","Total",2762,2225,1280,945,7,125,29,96,382,352,5,22,3,23
"2011","York 015","E02002786","Total",3996,1653,748,905,21,982,896,86,1294,1219,3,71,1,46
"2011","York 016","E02002787","Total",4276,2751,1316,1435,31,795,632,163,649,588,6,47,8,50
"2011","York 017","E02002788","Total",4053,2518,1111,1407,13,244,116,128,1233,1168,9,51,5,45
"2011","York 018","E02002789","Total",3830,1979,823,1156,18,1496,1254,242,282,247,1,28,6,55
"2011","York 019","E02002790","Total",4743,2280,1201,1079,53,529,312,217,1786,1581,75,69,61,95
"2011","York 020","E02002791","Total",2627,2254,1230,1024,11,136,99,37,190,174,1,8,7,36
"2011","York 021","E02002792","Total",3130,2245,1121,1124,5,126,10,116,727,689,4,31,3,27
"2011","York 022","E02002793","Total",4072,3121,1585,1536,32,578,399,179,297,258,3,30,6,44
"2011","York 023","E02002794","Total",2173,1518,896,622,20,196,133,63,399,351,6,17,25,40
"2011","York 024","E02002795","Total",3463,3062,1751,1311,10,136,104,32,225,197,2,22,4,30
"2011","Craven 001","E02005742","Total",3314,2512,1569,943,16,221,73,148,498,440,10,41,7,67
"2011","Craven 002","E02005743","Total",2290,1718,1204,514,29,139,19,120,340,291,21,13,15,64
"2011","Craven 003","E02005744","Total",3421,2549,1598,951,4,314,69,245,485,421,12,44,8,69
"2011","Craven 004","E02005745","Total",2154,1689,1071,618,5,71,20,51,334,303,14,9,8,55
"2011","Craven 005","E02005746","Total",2987,2108,1148,960,9,406,120,286,403,369,4,23,7,61
"2011","Craven 006","E02005747","Total",3042,1818,944,874,16,442,113,329,707,641,13,42,11,59
"2011","Craven 007","E02005748","Total",3215,2423,1238,1185,13,230,54,176,487,435,11,33,8,62
"2011","Craven 008","E02005749","Total",4160,3156,1624,1532,24,389,90,299,528,460,4,56,8,63
"2011","Hambleton 001","E02005750","Total",3574,2382,1429,953,7,705,70,635,410,376,6,26,2,70
"2011","Hambleton 002","E02005751","Total",3811,3230,2020,1210,10,168,14,154,333,298,11,24,0,70
"2011","Hambleton 003","E02005752","Total",2958,2050,1232,818,14,331,16,315,486,438,12,27,9,77
"2011","Hambleton 004","E02005753","Total",5775,3468,1721,1747,31,1430,112,1318,785,708,13,49,15,61
"2011","Hambleton 005","E02005754","Total",3170,2617,1604,1013,7,147,7,140,347,278,32,26,11,52
"2011","Hambleton 006","E02005755","Total",2765,1878,1010,868,10,380,23,357,433,384,10,35,4,64
"2011","Hambleton 007","E02005756","Total",2575,1597,921,676,7,159,6,153,745,352,261,31,101,67
"2011","Hambleton 008","E02005757","Total",3772,2605,1459,1146,14,309,16,293,766,682,23,50,11,78
"2011","Hambleton 009","E02005758","Total",3410,2212,1269,943,11,585,67,518,509,363,81,22,43,93
"2011","Hambleton 010","E02005759","Total",3797,2668,1585,1083,31,495,33,462,527,472,13,31,11,76
"2011","Hambleton 011","E02005760","Total",2510,1801,885,916,14,214,8,206,429,271,84,19,55,52
"2011","Harrogate 001","E02005761","Total",2336,1577,987,590,17,196,137,59,474,399,36,31,8,72
"2011","Harrogate 002","E02005762","Total",2410,1613,862,751,24,214,68,146,526,358,83,18,67,33
"2011","Harrogate 003","E02005763","Total",2576,1687,949,738,8,226,172,54,559,363,109,21,66,96
"2011","Harrogate 004","E02005764","Total",4549,2981,1524,1457,24,760,519,241,714,619,30,48,17,70
"2011","Harrogate 005","E02005765","Total",2635,1920,1009,911,13,207,151,56,437,390,12,23,12,58
"2011","Harrogate 006","E02005766","Total",2645,1904,1115,789,9,209,149,60,461,416,9,29,7,62
"2011","Harrogate 007","E02005767","Total",2749,2364,1315,1049,16,84,37,47,250,227,7,12,4,35
"2011","Harrogate 008","E02005768","Total",2357,1791,871,920,6,72,45,27,449,339,51,20,39,39
"2011","Harrogate 009","E02005769","Total",3173,1974,1006,968,11,593,388,205,547,493,7,44,3,48
"2011","Harrogate 010","E02005770","Total",4092,3350,1660,1690,15,180,118,62,505,434,7,60,4,42
"2011","Harrogate 011","E02005771","Total",3336,2254,876,1378,22,509,253,256,524,486,2,32,4,27
"2011","Harrogate 012","E02005772","Total",2481,2222,1263,959,17,35,20,15,184,164,4,14,2,23
"2011","Harrogate 013","E02005773","Total",4101,1948,770,1178,36,1124,889,235,904,846,6,45,7,89
"2011","Harrogate 014","E02005774","Total",3945,2846,1351,1495,38,471,195,276,536,489,5,35,7,54
"2011","Harrogate 015","E02005775","Total",4497,2165,1059,1106,23,376,31,345,1885,1814,11,51,9,48
"2011","Harrogate 016","E02005776","Total",3185,2426,1276,1150,14,229,165,64,434,387,17,22,8,82
"2011","Harrogate 017","E02005777","Total",3429,2934,1576,1358,34,158,76,82,268,237,3,26,2,35
"2011","Harrogate 018","E02005778","Total",2466,1836,1090,746,9,95,67,28,436,375,18,22,21,90
"2011","Harrogate 019","E02005779","Total",3548,2428,1417,1011,9,89,33,56,966,919,3,39,5,56
"2011","Harrogate 020","E02005780","Total",4362,3600,2062,1538,37,178,5,173,513,463,10,34,6,34
"2011","Harrogate 021","E02005781","Total",2297,1918,1080,838,13,133,90,43,199,176,8,12,3,34
"2011","Richmondshire 001","E02005782","Total",3325,2409,1413,996,11,221,192,29,568,502,16,38,12,116
"2011","Richmondshire 002","E02005783","Total",3775,2546,1472,1074,31,537,389,148,599,556,6,32,5,62
"2011","Richmondshire 003","E02005784","Total",2382,1634,774,860,7,270,153,117,434,244,107,30,53,37
"2011","Richmondshire 004","E02005785","Total",4183,1798,611,1187,7,660,442,218,1663,572,604,34,453,55
"2011","Richmondshire 005","E02005786","Total",2822,1991,1430,561,20,220,89,131,498,379,27,58,34,93
"2011","Richmondshire 006","E02005787","Total",3720,2532,1595,937,28,275,186,89,757,624,50,48,35,128
"2011","Ryedale 001","E02005788","Total",2846,2064,1388,676,6,256,16,240,443,390,11,32,10,77
"2011","Ryedale 002","E02005789","Total",4593,3290,2170,1120,26,577,49,528,609,536,8,49,16,91
"2011","Ryedale 003","E02005790","Total",2788,1856,1276,580,11,280,32,248,512,432,39,27,14,129
"2011","Ryedale 004","E02005791","Total",2792,1680,917,763,10,408,22,386,559,505,29,19,6,135
"2011","Ryedale 007","E02005794","Total",4076,2793,1700,1093,15,340,18,322,788,679,57,32,20,140
"2011","Ryedale 008","E02006870","Total",5429,3441,1878,1563,15,1035,76,959,862,779,19,57,7,76
"2011","Scarborough 001","E02005795","Total",3382,2028,1283,745,12,561,74,487,704,642,15,34,13,77
"2011","Scarborough 002","E02005796","Total",3007,2064,1337,727,22,319,71,248,512,451,11,37,13,90
"2011","Scarborough 003","E02005797","Total",2715,1805,1051,754,10,448,78,370,401,348,2,44,7,51
"2011","Scarborough 004","E02005798","Total",3802,3016,1997,1019,21,282,35,247,398,332,15,37,14,85
"2011","Scarborough 005","E02005799","Total",3950,3259,2035,1224,45,299,84,215,289,255,2,27,5,58
"2011","Scarborough 006","E02005800","Total",3924,1655,851,804,13,611,101,510,1575,1476,14,56,29,70
"2011","Scarborough 007","E02005801","Total",2364,1291,662,629,9,810,218,592,213,193,1,16,3,41
"2011","Scarborough 008","E02005802","Total",3468,2096,917,1179,9,163,7,156,1175,1096,5,66,8,25
"2011","Scarborough 009","E02005803","Total",4161,2645,1407,1238,49,707,98,609,713,635,14,45,19,47
"2011","Scarborough 010","E02005804","Total",4433,2064,1383,681,11,201,22,179,2091,1983,9,75,24,66
"2011","Scarborough 011","E02005805","Total",3182,2683,1591,1092,30,172,17,155,262,228,4,22,8,35
"2011","Scarborough 012","E02005806","Total",2926,1732,809,923,30,923,249,674,191,169,1,19,2,50
"2011","Scarborough 013","E02005807","Total",2687,2155,1267,888,8,133,24,109,334,294,8,25,7,57
"2011","Scarborough 014","E02005808","Total",5434,4027,2733,1294,33,505,85,420,782,710,7,56,9,87
"2011","Selby 001","E02005809","Total",3184,2299,1111,1188,6,455,437,18,354,299,30,21,4,70
"2011","Selby 002","E02005810","Total",3526,2802,1275,1527,22,212,156,56,421,379,11,23,8,69
"2011","Selby 003","E02005811","Total",3560,2879,1312,1567,15,242,183,59,376,330,8,30,8,48
"2011","Selby 004","E02005812","Total",3734,2831,1210,1621,17,504,384,120,340,305,6,27,2,42
"2011","Selby 005","E02005813","Total",4809,2286,874,1412,49,1438,809,629,979,918,7,49,5,57
"2011","Selby 006","E02005814","Total",2705,2068,1120,948,21,372,221,151,210,183,1,23,3,34
"2011","Selby 007","E02005815","Total",3339,2951,1416,1535,26,94,43,51,231,208,2,18,3,37
"2011","Selby 008","E02005816","Total",3370,2772,1237,1535,9,201,143,58,349,311,5,28,5,39
"2011","Selby 009","E02005817","Total",3029,2367,1109,1258,16,340,277,63,265,237,3,23,2,41
"2011","Selby 010","E02005818","Total",3303,2656,1265,1391,20,303,249,54,271,230,5,27,9,53
"2011","Barnsley 001","E02001509","Total",2696,1788,789,999,11,601,530,71,252,227,1,22,2,44
"2011","Barnsley 002","E02001510","Total",2537,1701,787,914,15,497,425,72,279,254,1,23,1,45
"2011","Barnsley 003","E02001511","Total",2673,1909,875,1034,4,442,403,39,280,261,0,17,2,38
"2011","Barnsley 004","E02001512","Total",3358,2441,1185,1256,6,536,470,66,320,285,4,28,3,55
"2011","Barnsley 005","E02001513","Total",3325,2631,1294,1337,5,320,289,31,337,305,1,29,2,32
"2011","Barnsley 006","E02001514","Total",2999,1748,721,1027,17,759,564,195,439,401,2,32,4,36
"2011","Barnsley 007","E02001515","Total",3918,1741,717,1024,38,1813,1684,129,240,212,5,20,3,86
"2011","Barnsley 008","E02001516","Total",2518,1634,641,993,4,489,446,43,346,311,0,31,4,45
"2011","Barnsley 009","E02001517","Total",3448,2570,1272,1298,6,582,508,74,245,220,6,18,1,45
"2011","Barnsley 010","E02001518","Total",4376,2887,1393,1494,12,899,752,147,502,456,2,41,3,76
"2011","Barnsley 011","E02001519","Total",2749,1603,774,829,10,833,693,140,260,236,4,19,1,43
"2011","Barnsley 012","E02001520","Total",4764,3750,2073,1677,37,493,412,81,435,392,1,39,3,49
"2011","Barnsley 013","E02001521","Total",5349,2977,1285,1692,37,559,402,157,1675,1574,9,70,22,101
"2011","Barnsley 014","E02001522","Total",3750,2042,1069,973,26,1124,677,447,496,454,2,37,3,62
"2011","Barnsley 015","E02001523","Total",3043,2170,1018,1152,18,230,179,51,585,542,2,38,3,40
"2011","Barnsley 016","E02001524","Total",2566,2036,1150,886,17,223,194,29,253,227,2,16,8,37
"2011","Barnsley 017","E02001525","Total",2955,1205,555,650,11,1072,722,350,598,567,2,24,5,69
"2011","Barnsley 018","E02001526","Total",2487,1082,475,607,12,1116,954,162,225,202,4,16,3,52
"2011","Barnsley 019","E02001527","Total",2573,1820,868,952,1,473,445,28,242,216,2,22,2,37
"2011","Barnsley 020","E02001528","Total",4424,2878,1489,1389,26,908,806,102,544,509,3,27,5,68
"2011","Barnsley 021","E02001529","Total",4180,2424,1272,1152,13,1321,1204,117,328,288,0,36,4,94
"2011","Barnsley 022","E02001530","Total",2748,1583,689,894,4,514,423,91,588,567,3,15,3,59
"2011","Barnsley 023","E02001531","Total",2954,1704,807,897,1,636,529,107,570,530,1,31,8,43
"2011","Barnsley 024","E02001532","Total",4067,3086,1428,1658,31,556,414,142,358,318,4,30,6,36
"2011","Barnsley 025","E02001533","Total",3125,2054,886,1168,7,519,475,44,516,480,2,32,2,29
"2011","Barnsley 026","E02001534","Total",3800,2409,1035,1374,11,875,793,82,444,405,0,33,6,61
"2011","Barnsley 027","E02001535","Total",2595,1950,992,958,7,302,256,46,286,257,9,12,8,50
"2011","Barnsley 028","E02001536","Total",3807,2624,1248,1376,30,669,613,56,417,382,2,32,1,67
"2011","Barnsley 029","E02001537","Total",3525,2297,949,1348,19,657,603,54,508,473,0,31,4,44
"2011","Barnsley 030","E02001538","Total",3425,2063,1042,1021,9,1014,966,48,288,261,2,16,9,51
"2011","Doncaster 001","E02001539","Total",2400,1530,694,836,7,522,472,50,305,266,1,36,2,36
"2011","Doncaster 002","E02001540","Total",4810,3313,1579,1734,12,722,677,45,670,615,5,45,5,93
"2011","Doncaster 003","E02001541","Total",4876,3098,1503,1595,27,878,702,176,777,698,5,65,9,96
"2011","Doncaster 004","E02001542","Total",3071,1610,805,805,6,977,864,113,411,376,5,28,2,67
"2011","Doncaster 005","E02001543","Total",3622,2228,1029,1199,3,886,789,97,436,400,2,33,1,69
"2011","Doncaster 006","E02001544","Total",3526,2415,1054,1361,9,630,611,19,420,372,2,45,1,52
"2011","Doncaster 007","E02001545","Total",3726,3121,1632,1489,20,222,194,28,329,300,1,25,3,34
"2011","Doncaster 008","E02001546","Total",2805,2342,1295,1047,6,134,107,27,290,256,3,28,3,33
"2011","Doncaster 009","E02001547","Total",4223,2588,1019,1569,9,1046,938,108,511,463,4,42,2,69
"2011","Doncaster 010","E02001548","Total",3397,1609,654,955,18,993,722,271,721,664,3,50,4,56
"2011","Doncaster 011","E02001549","Total",2521,1944,934,1010,5,270,216,54,268,242,3,18,5,34
"2011","Doncaster 012","E02001550","Total",3149,2220,979,1241,11,571,561,10,291,241,4,42,4,56
"2011","Doncaster 013","E02001551","Total",2656,1820,842,978,9,207,177,30,587,539,7,36,5,33
"2011","Doncaster 014","E02001552","Total",3151,1989,733,1256,2,542,466,76,559,516,4,34,5,59
"2011","Doncaster 015","E02001553","Total",4193,2565,1216,1349,4,996,879,117,548,486,3,55,4,80
"2011","Doncaster 016","E02001554","Total",2625,2170,1042,1128,26,156,149,7,237,217,0,19,1,36
"2011","Doncaster 017","E02001555","Total",2463,2040,1022,1018,11,143,133,10,249,217,0,31,1,20
"2011","Doncaster 018","E02001556","Total",3764,2107,883,1224,6,1148,1112,36,433,371,17,39,6,70
"2011","Doncaster 019","E02001557","Total",3965,2408,1140,1268,7,206,45,161,1284,1207,12,57,8,60
"2011","Doncaster 020","E02001558","Total",2715,2055,1129,926,20,263,225,38,320,297,11,10,2,57
"2011","Doncaster 021","E02001559","Total",3165,2734,1422,1312,1,57,48,9,332,294,8,28,2,41
"2011","Doncaster 022","E02001560","Total",4318,1727,825,902,18,833,542,291,1655,1580,14,44,17,85
"2011","Doncaster 023","E02001561","Total",2953,1271,510,761,20,1031,879,152,572,521,3,38,10,59
"2011","Doncaster 024","E02001562","Total",2634,1569,720,849,3,761,664,97,228,208,2,17,1,73
"2011","Doncaster 025","E02001563","Total",3254,2519,1434,1085,12,300,220,80,385,338,1,41,5,38
"2011","Doncaster 026","E02001564","Total",3146,2746,1478,1268,3,88,79,9,268,233,6,26,3,41
"2011","Doncaster 027","E02001565","Total",2860,2271,1265,1006,21,74,57,17,467,430,2,33,2,27
"2011","Doncaster 028","E02001566","Total",3330,1715,513,1202,9,566,430,136,973,913,1,51,8,67
"2011","Doncaster 029","E02001567","Total",3786,2318,1083,1235,7,941,764,177,462,397,1,60,4,58
"2011","Doncaster 030","E02001568","Total",2623,1440,732,708,7,853,821,32,271,243,4,21,3,52
"2011","Doncaster 031","E02001569","Total",3926,2147,966,1181,23,955,774,181,762,715,4,37,6,39
"2011","Doncaster 032","E02001570","Total",3114,1351,582,769,5,1305,1131,174,364,325,1,33,5,89
"2011","Doncaster 033","E02001571","Total",2620,2043,1110,933,7,193,186,7,327,293,2,30,2,50
"2011","Doncaster 034","E02001572","Total",2997,1784,747,1037,3,740,627,113,417,379,8,28,2,53
"2011","Doncaster 035","E02001573","Total",3126,2141,927,1214,3,575,548,27,333,295,1,36,1,74
"2011","Doncaster 036","E02001574","Total",2596,2176,962,1214,11,115,99,16,279,247,5,25,2,15
"2011","Doncaster 037","E02001575","Total",2941,1566,582,984,4,917,888,29,389,353,2,31,3,65
"2011","Doncaster 038","E02001576","Total",2459,1728,801,927,33,312,135,177,350,318,1,27,4,36
"2011","Doncaster 039","E02001577","Total",2981,2342,1410,932,10,275,242,33,294,259,1,27,7,60
"2011","Rotherham 001","E02001578","Total",3946,2604,945,1659,7,873,816,57,402,348,1,47,6,60
"2011","Rotherham 002","E02001579","Total",3919,2359,1168,1191,25,1076,890,186,388,359,2,24,3,71
"2011","Rotherham 003","E02001580","Total",3681,2555,1394,1161,11,716,592,124,343,311,3,24,5,56
"2011","Rotherham 004","E02001581","Total",2466,1641,791,850,3,644,620,24,140,122,0,15,3,38
"2011","Rotherham 005","E02001582","Total",3044,1888,892,996,7,934,901,33,171,150,2,17,2,44
"2011","Rotherham 006","E02001583","Total",2423,1611,721,890,26,417,352,65,340,307,1,31,1,29
"2011","Rotherham 007","E02001584","Total",2994,2311,1100,1211,4,251,167,84,392,364,1,15,12,36
"2011","Rotherham 008","E02001585","Total",2772,1298,478,820,8,976,818,158,420,388,2,26,4,70
"2011","Rotherham 009","E02001586","Total",3992,1875,829,1046,6,1754,1620,134,284,246,1,29,8,73
"2011","Rotherham 010","E02001587","Total",2558,1227,543,684,2,1033,891,142,245,214,2,20,9,51
"2011","Rotherham 011","E02001588","Total",3022,1519,622,897,3,1286,1277,9,153,136,0,17,0,61
"2011","Rotherham 012","E02001589","Total",3448,2838,1183,1655,17,224,209,15,337,279,3,50,5,32
"2011","Rotherham 013","E02001590","Total",2913,1048,375,673,3,1543,1440,103,236,211,4,18,3,83
"2011","Rotherham 014","E02001591","Total",3267,1579,720,859,10,1101,737,364,504,470,3,26,5,73
"2011","Rotherham 015","E02001592","Total",3766,2773,1350,1423,24,661,591,70,253,226,2,25,0,55
"2011","Rotherham 016","E02001593","Total",2853,1197,551,646,7,887,478,409,675,635,3,32,5,87
"2011","Rotherham 017","E02001594","Total",2833,1001,488,513,18,914,540,374,796,760,2,20,14,104
"2011","Rotherham 018","E02001595","Total",3577,2909,1196,1713,2,336,295,41,271,233,3,35,0,59
"2011","Rotherham 019","E02001596","Total",3687,2462,1225,1237,8,599,455,144,581,554,0,24,3,37
"2011","Rotherham 020","E02001597","Total",4060,2212,1100,1112,10,968,538,430,795,746,3,34,12,75
"2011","Rotherham 021","E02001598","Total",4068,2793,1413,1380,13,806,645,161,390,357,3,27,3,66
"2011","Rotherham 022","E02001599","Total",2627,2111,1017,1094,20,238,195,43,227,194,2,29,2,31
"2011","Rotherham 023","E02001600","Total",4126,3077,1721,1356,7,469,308,161,508,472,4,28,4,65
"2011","Rotherham 024","E02001601","Total",2188,1607,827,780,6,373,318,55,168,146,2,18,2,34
"2011","Rotherham 025","E02001602","Total",3745,2775,1382,1393,16,528,437,91,383,342,7,26,8,43
"2011","Rotherham 026","E02001603","Total",2794,1823,873,950,7,509,501,8,394,364,2,26,2,61
"2011","Rotherham 027","E02001604","Total",3455,2379,877,1502,6,585,545,40,430,396,2,30,2,55
"2011","Rotherham 028","E02001605","Total",3079,2272,927,1345,5,361,250,111,400,355,3,31,11,41
"2011","Rotherham 029","E02001606","Total",3306,2396,1153,1243,7,376,334,42,486,448,5,30,3,41
"2011","Rotherham 030","E02001607","Total",3755,2601,1292,1309,5,817,741,76,275,243,0,29,3,57
"2011","Rotherham 031","E02001608","Total",2818,2274,983,1291,2,246,236,10,266,239,0,22,5,30
"2011","Rotherham 032","E02001609","Total",3578,2920,1622,1298,1,380,375,5,236,205,2,26,3,41
"2011","Rotherham 033","E02001610","Total",3533,2675,1273,1402,13,408,324,84,373,333,4,29,7,64
"2011","Sheffield 001","E02001611","Total",3356,2399,1201,1198,5,595,542,53,321,283,1,25,12,36
"2011","Sheffield 002","E02001612","Total",2539,2046,947,1099,4,275,265,10,191,177,0,14,0,23
"2011","Sheffield 003","E02001613","Total",4522,3213,1459,1754,7,993,931,62,274,251,0,18,5,35
"2011","Sheffield 004","E02001614","Total",4728,3921,1778,2143,11,441,390,51,324,280,3,38,3,31
"2011","Sheffield 005","E02001615","Total",3289,2800,1540,1260,7,176,148,28,274,248,4,21,1,32
"2011","Sheffield 006","E02001616","Total",3116,1934,867,1067,12,931,890,41,214,190,2,20,2,25
"2011","Sheffield 007","E02001617","Total",2287,1002,330,672,1,1115,244,871,155,140,0,10,5,14
"2011","Sheffield 008","E02001618","Total",4057,3071,1368,1703,17,498,377,121,426,374,3,37,12,45
"2011","Sheffield 009","E02001619","Total",3996,1886,803,1083,3,1918,1872,46,167,133,1,30,3,22
"2011","Sheffield 010","E02001620","Total",2773,1203,409,794,18,1236,394,842,296,258,1,17,20,20
"2011","Sheffield 011","E02001621","Total",2305,1070,488,582,2,1046,899,147,169,156,1,11,1,18
"2011","Sheffield 012","E02001622","Total",4004,1885,815,1070,4,1809,1585,224,279,245,1,25,8,27
"2011","Sheffield 013","E02001623","Total",3301,1120,467,653,9,1928,1626,302,217,194,0,20,3,27
"2011","Sheffield 014","E02001624","Total",4020,2641,1177,1464,11,739,355,384,598,554,2,39,3,31
"2011","Sheffield 015","E02001625","Total",3179,1350,523,827,3,1624,1351,273,181,152,6,15,8,21
"2011","Sheffield 016","E02001626","Total",2474,1764,810,954,4,386,38,348,303,272,1,24,6,17
"2011","Sheffield 017","E02001627","Total",2788,1701,642,1059,10,401,325,76,646,596,0,44,6,30
"2011","Sheffield 018","E02001628","Total",2235,1027,563,464,15,711,505,206,438,376,8,43,11,44
"2011","Sheffield 019","E02001629","Total",2858,1119,518,601,17,1408,1205,203,289,264,2,16,7,25
"2011","Sheffield 020","E02001630","Total",2802,1618,916,702,9,562,313,249,557,521,2,24,10,56
"2011","Sheffield 021","E02001631","Total",3357,2358,987,1371,5,540,129,411,430,373,3,41,13,24
"2011","Sheffield 022","E02001632","Total",4370,1287,687,600,107,1685,1196,489,1189,1133,1,35,20,102
"2011","Sheffield 023","E02001633","Total",3177,2576,1372,1204,2,396,310,86,183,153,2,25,3,20
"2011","Sheffield 024","E02001634","Total",4398,2849,1263,1586,13,496,299,197,1008,933,2,68,5,32
"2011","Sheffield 025","E02001635","Total",2930,1853,930,923,1,939,908,31,119,90,0,25,4,18
"2011","Sheffield 026","E02001636","Total",4176,1261,540,721,22,2083,1772,311,764,704,2,39,19,46
"2011","Sheffield 027","E02001637","Total",2350,855,375,480,16,1078,651,427,362,328,1,21,12,39
"2011","Sheffield 028","E02001638","Total",2218,942,437,505,13,103,83,20,1136,1060,2,68,6,24
"2011","Sheffield 029","E02001639","Total",2779,1664,813,851,10,229,188,41,845,779,2,61,3,31
"2011","Sheffield 030","E02001640","Total",2871,967,456,511,27,470,180,290,1378,1337,0,29,12,29
"2011","Sheffield 032","E02001642","Total",4011,3020,1349,1671,7,471,429,42,483,419,2,56,6,30
"2011","Sheffield 033","E02001643","Total",2729,2182,1223,959,4,312,226,86,199,180,0,17,2,32
"2011","Sheffield 036","E02001646","Total",2758,1029,552,477,13,289,121,168,1398,1239,28,21,110,29
"2011","Sheffield 037","E02001647","Total",2682,1825,890,935,17,629,292,337,193,164,2,23,4,18
"2011","Sheffield 038","E02001648","Total",2769,1870,1013,857,5,145,20,125,726,561,12,24,129,23
"2011","Sheffield 039","E02001649","Total",4178,1217,395,822,13,2436,800,1636,476,406,6,34,30,36
"2011","Sheffield 040","E02001650","Total",3391,696,328,368,5,1252,949,303,1391,1338,7,29,17,47
"2011","Sheffield 041","E02001651","Total",3306,3015,1718,1297,6,65,61,4,197,172,2,22,1,23
"2011","Sheffield 042","E02001652","Total",3791,1162,472,690,36,594,341,253,1944,1815,6,69,54,55
"2011","Sheffield 043","E02001653","Total",3101,992,381,611,33,1557,1070,487,494,450,6,24,14,25
"2011","Sheffield 044","E02001654","Total",2639,1827,827,1000,39,595,309,286,163,146,0,12,5,15
"2011","Sheffield 045","E02001655","Total",3419,1811,760,1051,6,1330,952,378,253,219,0,25,9,19
"2011","Sheffield 046","E02001656","Total",3042,2012,986,1026,7,65,25,40,929,874,4,46,5,29
"2011","Sheffield 047","E02001657","Total",3619,3019,1454,1565,11,66,15,51,502,469,3,29,1,21
"2011","Sheffield 048","E02001658","Total",2321,738,256,482,3,1401,1295,106,158,142,0,7,9,21
"2011","Sheffield 049","E02001659","Total",2976,1372,558,814,9,1355,1218,137,219,199,2,15,3,21
"2011","Sheffield 050","E02001660","Total",4084,2501,1118,1383,45,296,62,234,1199,1126,4,55,14,43
"2011","Sheffield 051","E02001661","Total",3647,1566,636,930,8,1619,1398,221,423,363,2,41,17,31
"2011","Sheffield 052","E02001662","Total",3394,2324,1094,1230,4,704,448,256,333,283,2,38,10,29
"2011","Sheffield 053","E02001663","Total",3343,2322,837,1485,6,144,35,109,849,792,2,50,5,22
"2011","Sheffield 054","E02001664","Total",2768,2048,1034,1014,2,493,462,31,208,185,0,21,2,17
"2011","Sheffield 055","E02001665","Total",3794,3459,1906,1553,6,99,44,55,202,184,3,13,2,28
"2011","Sheffield 056","E02001666","Total",2584,1557,579,978,15,750,618,132,246,216,3,24,3,16
"2011","Sheffield 059","E02001669","Total",3500,2507,1031,1476,7,217,178,39,744,678,4,58,4,25
"2011","Sheffield 060","E02001670","Total",2766,1169,512,657,8,1377,1238,139,188,164,3,16,5,24
"2011","Sheffield 061","E02001671","Total",2669,2070,984,1086,16,423,303,120,140,120,0,19,1,20
"2011","Sheffield 062","E02001672","Total",2734,1949,979,970,5,553,494,59,199,171,2,25,1,28
"2011","Sheffield 063","E02001673","Total",2195,1911,664,1247,9,72,38,34,191,177,1,13,0,12
"2011","Sheffield 064","E02001674","Total",3904,3169,1706,1463,7,454,307,147,238,198,4,32,4,36
"2011","Sheffield 065","E02001675","Total",4149,2559,1091,1468,6,1305,1114,191,255,210,4,35,6,24
"2011","Sheffield 066","E02001676","Total",2514,2230,1127,1103,1,151,146,5,119,102,3,10,4,13
"2011","Sheffield 068","E02001678","Total",4344,3712,2206,1506,3,280,260,20,312,283,9,18,2,37
"2011","Sheffield 069","E02001679","Total",3011,1493,724,769,9,1275,1203,72,215,189,1,22,3,19
"2011","Sheffield 070","E02001680","Total",3133,1017,434,583,15,1879,1775,104,191,166,0,23,2,31
"2011","Sheffield 071","E02001681","Total",3332,2702,1418,1284,7,413,287,126,185,162,2,21,0,25
"2011","Sheffield 072","E02006803","Total",3763,3063,1217,1846,22,259,227,32,391,350,1,34,6,28
"2011","Sheffield 073","E02006843","Total",3270,364,118,246,15,419,97,322,2425,2306,17,36,66,47
"2011","Sheffield 074","E02006844","Total",3155,390,174,216,16,888,238,650,1818,1725,9,52,32,43
"2011","Sheffield 075","E02006868","Total",5068,1723,791,932,23,2175,494,1681,927,837,2,39,49,220
"2011","Sheffield 076","E02006869","Total",4820,3153,1306,1847,27,1299,1165,134,304,271,2,30,1,37
"2011","Bradford 001","E02002183","Total",2579,2083,1186,897,17,175,60,115,265,241,3,19,2,39
"2011","Bradford 002","E02002184","Total",5556,4362,2515,1847,21,381,87,294,714,663,5,43,3,78
"2011","Bradford 003","E02002185","Total",2478,1985,973,1012,32,204,80,124,231,203,0,27,1,26
"2011","Bradford 004","E02002186","Total",5450,4274,2157,2117,22,247,96,151,844,768,3,60,13,63
"2011","Bradford 005","E02002187","Total",2475,2155,1223,932,5,98,21,77,188,166,1,16,5,29
"2011","Bradford 006","E02002188","Total",3173,2718,1329,1389,45,32,14,18,346,316,0,28,2,32
"2011","Bradford 007","E02002189","Total",2249,1745,872,873,5,122,46,76,335,304,4,22,5,42
"2011","Bradford 008","E02002190","Total",4222,2581,1288,1293,8,516,120,396,1055,965,8,61,21,62
"2011","Bradford 009","E02002191","Total",3523,2021,831,1190,22,781,358,423,643,578,4,55,6,56
"2011","Bradford 010","E02002192","Total",3910,3278,1642,1636,12,218,99,119,362,332,4,25,1,40
"2011","Bradford 011","E02002193","Total",2828,1406,602,804,5,790,331,459,560,517,2,34,7,67
"2011","Bradford 012","E02002194","Total",3107,2254,1015,1239,15,508,265,243,288,251,2,34,1,42
"2011","Bradford 013","E02002195","Total",2766,2304,1193,1111,6,176,56,120,233,197,6,26,4,47
"2011","Bradford 014","E02002196","Total",2622,1979,828,1151,42,185,103,82,396,350,2,43,1,20
"2011","Bradford 015","E02002197","Total",4019,2485,1087,1398,18,492,163,329,979,913,9,50,7,45
"2011","Bradford 016","E02002198","Total",3766,2749,1210,1539,11,499,264,235,442,396,2,40,4,65
"2011","Bradford 017","E02002199","Total",2804,2163,955,1208,22,183,46,137,412,376,2,28,6,24
"2011","Bradford 018","E02002200","Total",4032,2855,1399,1456,58,458,205,253,624,586,1,35,2,37
"2011","Bradford 019","E02002201","Total",5203,3467,1121,2346,82,909,347,562,673,606,3,57,7,72
"2011","Bradford 020","E02002202","Total",3408,1707,759,948,15,552,272,280,1070,1031,7,23,9,64
"2011","Bradford 021","E02002203","Total",3285,1939,760,1179,26,869,473,396,391,352,2,35,2,60
"2011","Bradford 022","E02002204","Total",4900,3948,1850,2098,21,352,147,205,542,472,4,60,6,37
"2011","Bradford 023","E02002205","Total",4476,3423,1628,1795,44,164,22,142,790,723,4,57,6,55
"2011","Bradford 024","E02002206","Total",3427,2534,1087,1447,25,404,199,205,431,387,0,43,1,33
"2011","Bradford 025","E02002207","Total",2307,1600,747,853,5,153,46,107,520,491,2,20,7,29
"2011","Bradford 026","E02002208","Total",3235,2075,846,1229,52,549,239,310,533,478,3,46,6,26
"2011","Bradford 027","E02002209","Total",2283,1058,386,672,6,870,529,341,314,288,1,24,1,35
"2011","Bradford 028","E02002210","Total",2824,2218,1030,1188,12,113,29,84,448,403,1,42,2,33
"2011","Bradford 029","E02002211","Total",2064,1513,674,839,18,95,15,80,404,365,3,32,4,34
"2011","Bradford 030","E02002212","Total",2260,1490,567,923,13,328,178,150,390,360,4,18,8,39
"2011","Bradford 031","E02002213","Total",2917,2120,970,1150,11,339,113,226,394,350,2,40,2,53
"2011","Bradford 032","E02002214","Total",2404,1936,832,1104,30,37,18,19,382,345,2,32,3,19
"2011","Bradford 033","E02002215","Total",2733,1728,789,939,5,300,67,233,646,597,4,28,17,54
"2011","Bradford 034","E02002216","Total",2700,1205,685,520,11,843,103,740,573,527,2,28,16,68
"2011","Bradford 035","E02002217","Total",2995,1694,732,962,6,396,101,295,849,776,3,60,10,50
"2011","Bradford 036","E02002218","Total",3685,2281,944,1337,12,827,411,416,519,472,2,32,13,46
"2011","Bradford 037","E02002219","Total",2152,1355,593,762,26,194,74,120,538,485,1,42,10,39
"2011","Bradford 038","E02002220","Total",2561,1592,678,914,6,447,255,192,461,420,1,31,9,55
"2011","Bradford 039","E02002221","Total",4961,1279,656,623,51,1606,423,1183,1909,1805,6,48,50,116
"2011","Bradford 040","E02002222","Total",2944,1824,736,1088,16,568,248,320,500,463,3,30,4,36
"2011","Bradford 041","E02002223","Total",2216,1115,547,568,9,391,79,312,662,616,1,32,13,39
"2011","Bradford 042","E02002224","Total",2803,1587,842,745,8,412,104,308,721,674,2,41,4,75
"2011","Bradford 043","E02002225","Total",3448,2508,1039,1469,13,355,150,205,535,478,3,47,7,37
"2011","Bradford 044","E02002226","Total",3478,1703,1026,677,9,145,13,132,1543,1481,3,37,22,78
"2011","Bradford 045","E02002227","Total",2444,908,392,516,6,853,274,579,631,549,5,30,47,46
"2011","Bradford 046","E02002228","Total",2824,1228,520,708,7,998,192,806,536,490,3,32,11,55
"2011","Bradford 047","E02002229","Total",3152,2173,949,1224,21,410,163,247,510,456,1,47,6,38
"2011","Bradford 048","E02002230","Total",3332,941,509,432,50,1154,340,814,1100,1054,2,16,28,87
"2011","Bradford 049","E02002231","Total",4442,3064,1247,1817,21,492,207,285,798,733,1,55,9,67
"2011","Bradford 050","E02002232","Total",2516,1379,606,773,8,371,66,305,722,680,2,35,5,36
"2011","Bradford 051","E02002233","Total",2695,1416,619,797,12,689,377,312,525,495,1,20,9,53
"2011","Bradford 052","E02002234","Total",3192,965,296,669,3,1795,1058,737,353,328,1,18,6,76
"2011","Bradford 053","E02002235","Total",2438,1387,643,744,12,493,145,348,471,435,0,31,5,75
"2011","Bradford 054","E02002236","Total",2493,1918,869,1049,26,85,30,55,438,389,3,44,2,26
"2011","Bradford 055","E02002237","Total",3258,2288,910,1378,13,298,171,127,634,591,2,38,3,25
"2011","Bradford 056","E02002238","Total",2546,1414,556,858,7,605,258,347,476,439,1,30,6,44
"2011","Bradford 057","E02002239","Total",4000,2496,872,1624,19,670,271,399,768,714,1,42,11,47
"2011","Bradford 058","E02002240","Total",4423,3389,1280,2109,26,279,124,155,681,622,3,52,4,48
"2011","Bradford 059","E02002241","Total",4897,3052,1068,1984,11,1055,532,523,705,631,1,65,8,74
"2011","Bradford 060","E02002242","Total",3369,2578,1167,1411,10,278,61,217,448,408,3,32,5,55
"2011","Bradford 061","E02002243","Total",4047,2658,1155,1503,15,705,391,314,619,554,5,55,5,50
"2011","Calderdale 001","E02002244","Total",2525,1935,899,1036,24,323,156,167,214,170,6,36,2,29
"2011","Calderdale 002","E02002245","Total",2441,1062,419,643,6,1020,533,487,316,284,1,22,9,37
"2011","Calderdale 003","E02002246","Total",4183,3429,1708,1721,6,222,46,176,495,443,5,43,4,31
"2011","Calderdale 004","E02002247","Total",4310,3096,1566,1530,44,413,94,319,713,658,3,44,8,44
"2011","Calderdale 005","E02002248","Total",3180,1870,749,1121,4,821,371,450,441,376,3,59,3,44
"2011","Calderdale 006","E02002249","Total",2385,1222,460,762,15,744,344,400,380,327,3,45,5,24
"2011","Calderdale 007","E02002250","Total",3805,2710,1416,1294,5,491,122,369,551,485,2,57,7,48
"2011","Calderdale 008","E02002251","Total",3869,1676,725,951,21,1054,345,709,1061,978,6,64,13,57
"2011","Calderdale 009","E02002252","Total",2570,1976,1037,939,8,322,65,257,236,204,1,26,5,28
"2011","Calderdale 010","E02002253","Total",2957,1847,770,1077,3,374,112,262,675,608,3,50,14,58
"2011","Calderdale 011","E02002254","Total",2497,2024,1022,1002,5,138,29,109,313,284,2,26,1,17
"2011","Calderdale 012","E02002255","Total",2485,1037,601,436,5,809,207,602,558,506,2,34,16,76
"2011","Calderdale 013","E02002256","Total",4156,2637,1283,1354,50,658,223,435,752,681,8,54,9,59
"2011","Calderdale 014","E02002257","Total",2074,1339,647,692,10,132,11,121,541,484,3,38,16,52
"2011","Calderdale 015","E02002258","Total",4005,2720,1228,1492,12,508,204,304,713,653,8,37,15,52
"2011","Calderdale 016","E02002259","Total",2902,2096,1035,1061,4,212,10,202,553,497,2,44,10,37
"2011","Calderdale 017","E02002260","Total",4301,2554,1159,1395,47,776,236,540,866,800,2,56,8,58
"2011","Calderdale 018","E02002261","Total",3655,2466,1104,1362,5,469,213,256,679,620,3,53,3,36
"2011","Calderdale 019","E02002262","Total",3689,2507,1284,1223,9,521,217,304,605,564,4,34,3,47
"2011","Calderdale 020","E02002263","Total",2881,1854,785,1069,3,601,222,379,371,332,0,34,5,52
"2011","Calderdale 021","E02002264","Total",3030,2343,1186,1157,1,182,5,177,466,418,8,33,7,38
"2011","Calderdale 022","E02002265","Total",2512,1736,825,911,11,298,65,233,426,379,8,36,3,41
"2011","Calderdale 023","E02002266","Total",2556,1937,929,1008,11,200,60,140,375,344,2,26,3,33
"2011","Calderdale 024","E02002267","Total",3510,2389,1040,1349,5,756,382,374,310,275,4,28,3,50
"2011","Calderdale 025","E02002268","Total",4519,2698,1257,1441,26,841,296,545,890,816,4,63,7,64
"2011","Calderdale 026","E02002269","Total",4106,3043,1297,1746,50,395,123,272,571,508,3,54,6,47
"2011","Calderdale 027","E02002270","Total",3518,2778,1240,1538,7,214,62,152,474,420,2,45,7,45
"2011","Kirklees 001","E02002271","Total",3040,2423,1111,1312,3,193,63,130,386,331,1,52,2,35
"2011","Kirklees 002","E02002272","Total",4107,2641,1118,1523,10,937,870,67,430,378,1,45,6,89
"2011","Kirklees 003","E02002273","Total",2702,2049,959,1090,4,253,227,26,347,314,2,27,4,49
"2011","Kirklees 004","E02002274","Total",2879,2168,899,1269,8,328,279,49,334,293,3,34,4,41
"2011","Kirklees 005","E02002275","Total",3942,2514,1057,1457,12,643,526,117,706,640,0,61,5,67
"2011","Kirklees 006","E02002276","Total",2976,2099,958,1141,6,426,340,86,403,352,1,44,6,42
"2011","Kirklees 007","E02002277","Total",2527,1778,925,853,3,273,144,129,430,400,3,23,4,43
"2011","Kirklees 008","E02002278","Total",2680,1689,715,974,4,628,466,162,311,287,3,19,2,48
"2011","Kirklees 009","E02002279","Total",2780,1521,584,937,2,749,560,189,444,405,3,31,5,64
"2011","Kirklees 010","E02002280","Total",2274,963,537,426,38,930,597,333,265,247,2,11,5,78
"2011","Kirklees 011","E02002281","Total",4340,3008,1200,1808,17,627,449,178,614,556,3,46,9,74
"2011","Kirklees 012","E02002282","Total",2536,1668,704,964,14,372,328,44,435,400,1,29,5,47
"2011","Kirklees 013","E02002283","Total",2413,1540,940,600,20,436,328,108,363,323,1,35,4,54
"2011","Kirklees 014","E02002284","Total",2648,1996,1005,991,4,299,289,10,306,275,1,27,3,43
"2011","Kirklees 015","E02002285","Total",3356,2651,1306,1345,4,217,160,57,442,404,3,29,6,42
"2011","Kirklees 016","E02002286","Total",2372,1318,526,792,7,612,532,80,383,341,12,20,10,52
"2011","Kirklees 017","E02002287","Total",2732,1260,592,668,7,600,398,202,795,751,2,30,12,70
"2011","Kirklees 018","E02002288","Total",3831,2283,861,1422,45,989,859,130,455,406,2,44,3,59
"2011","Kirklees 019","E02002289","Total",2126,1165,463,702,5,637,508,129,261,239,1,18,3,58
"2011","Kirklees 020","E02002290","Total",2697,2171,1168,1003,8,191,183,8,283,257,1,22,3,44
"2011","Kirklees 021","E02002291","Total",2709,2053,1005,1048,7,316,292,24,304,265,3,31,5,29
"2011","Kirklees 022","E02002292","Total",2391,1840,871,969,3,250,196,54,271,248,0,19,4,27
"2011","Kirklees 023","E02002293","Total",2624,1353,598,755,6,656,459,197,529,484,2,38,5,80
"2011","Kirklees 024","E02002294","Total",3102,2050,1162,888,7,604,479,125,363,318,2,35,8,78
"2011","Kirklees 025","E02002295","Total",2951,1230,464,766,18,1285,1070,215,321,282,1,31,7,97
"2011","Kirklees 026","E02002296","Total",3114,2065,1035,1030,9,429,344,85,551,502,5,37,7,60
"2011","Kirklees 027","E02002297","Total",2773,2204,1174,1030,2,88,73,15,447,403,0,40,4,32
"2011","Kirklees 028","E02002298","Total",2878,1804,890,914,4,795,784,11,224,177,3,37,7,51
"2011","Kirklees 029","E02002299","Total",2852,1033,478,555,21,906,654,252,807,754,6,39,8,85
"2011","Kirklees 030","E02002300","Total",2931,2293,1255,1038,5,224,158,66,375,340,2,30,3,34
"2011","Kirklees 031","E02002301","Total",2839,1582,717,865,16,294,157,137,886,829,3,45,9,61
"2011","Kirklees 032","E02002302","Total",2650,2158,1026,1132,7,136,109,27,327,293,1,32,1,22
"2011","Kirklees 033","E02002303","Total",2880,1836,921,915,20,312,243,69,673,635,5,29,4,39
"2011","Kirklees 034","E02002304","Total",2972,1472,800,672,5,315,32,283,1135,1086,5,41,3,45
"2011","Kirklees 035","E02002305","Total",2639,1332,599,733,11,815,724,91,411,370,3,34,4,70
"2011","Kirklees 036","E02002306","Total",2692,2207,1074,1133,5,142,112,30,298,263,2,30,3,40
"2011","Kirklees 037","E02002307","Total",2623,1858,877,981,18,419,336,83,277,240,0,37,0,51
"2011","Kirklees 038","E02002308","Total",2876,2076,902,1174,6,286,274,12,478,427,5,44,2,30
"2011","Kirklees 039","E02002309","Total",2838,1430,700,730,9,544,384,160,786,735,4,41,6,69
"2011","Kirklees 040","E02002310","Total",2713,1592,679,913,5,587,498,89,498,469,1,25,3,31
"2011","Kirklees 041","E02002311","Total",2812,1858,796,1062,3,463,407,56,439,387,3,44,5,49
"2011","Kirklees 042","E02002312","Total",3054,1209,524,685,13,823,560,263,955,907,2,37,9,54
"2011","Kirklees 043","E02002313","Total",2544,1412,705,707,10,278,124,154,777,732,4,33,8,67
"2011","Kirklees 044","E02002314","Total",2624,1965,1078,887,4,305,254,51,310,269,2,32,7,40
"2011","Kirklees 045","E02002315","Total",3028,1908,728,1180,21,352,187,165,710,664,1,41,4,37
"2011","Kirklees 046","E02002316","Total",2758,2187,1147,1040,17,297,281,16,211,189,0,20,2,46
"2011","Kirklees 047","E02002317","Total",2920,1837,875,962,14,515,421,94,478,440,1,31,6,76
"2011","Kirklees 048","E02002318","Total",2883,1673,837,836,24,802,640,162,313,282,1,28,2,71
"2011","Kirklees 049","E02002319","Total",2876,2126,957,1169,6,218,183,35,501,456,3,39,3,25
"2011","Kirklees 050","E02002320","Total",3097,2161,1193,968,9,503,453,50,364,320,3,31,10,60
"2011","Kirklees 051","E02002321","Total",2569,2058,1066,992,18,144,127,17,314,281,2,28,3,35
"2011","Kirklees 052","E02002322","Total",2781,2117,1067,1050,2,238,213,25,374,344,1,25,4,50
"2011","Kirklees 053","E02002323","Total",3612,2846,1463,1383,7,324,282,42,383,346,1,35,1,52
"2011","Kirklees 054","E02002324","Total",2811,2135,1088,1047,4,308,250,58,322,297,1,23,1,42
"2011","Kirklees 055","E02002325","Total",3567,2660,1307,1353,21,392,329,63,440,396,3,34,7,54
"2011","Kirklees 056","E02002326","Total",2509,2130,993,1137,13,104,78,26,232,207,5,14,6,30
"2011","Kirklees 057","E02002327","Total",4086,3309,1639,1670,7,215,183,32,488,433,9,38,8,67
"2011","Kirklees 058","E02002328","Total",2942,2364,1230,1134,3,177,159,18,348,299,4,40,5,50
"2011","Kirklees 059","E02002329","Total",5047,4033,2021,2012,11,324,271,53,628,555,11,56,6,51
"2011","Leeds 001","E02002330","Total",2785,2497,1435,1062,4,108,100,8,147,139,2,6,0,29
"2011","Leeds 002","E02002331","Total",2679,1672,865,807,13,598,451,147,344,319,3,19,3,52
"2011","Leeds 003","E02002332","Total",2534,1816,957,859,15,529,448,81,137,117,2,15,3,37
"2011","Leeds 004","E02002333","Total",3625,2641,1324,1317,14,386,265,121,535,492,5,33,5,49
"2011","Leeds 005","E02002334","Total",3156,2448,1325,1123,4,337,295,42,308,258,21,24,5,59
"2011","Leeds 006","E02002335","Total",3154,2613,1393,1220,6,204,185,19,277,244,7,21,5,54
"2011","Leeds 007","E02002336","Total",2826,2412,1339,1073,13,143,118,25,222,199,5,13,5,36
"2011","Leeds 008","E02002337","Total",2830,2312,1106,1206,45,182,76,106,259,229,0,24,6,32
"2011","Leeds 009","E02002338","Total",2888,2167,1048,1119,9,329,240,89,349,318,2,24,5,34
"2011","Leeds 010","E02002339","Total",2597,1451,606,845,6,780,603,177,311,280,1,28,2,49
"2011","Leeds 011","E02002340","Total",2536,1806,900,906,16,397,321,76,298,270,1,24,3,19
"2011","Leeds 012","E02002341","Total",3016,2619,1416,1203,5,27,20,7,325,301,4,18,2,40
"2011","Leeds 013","E02002342","Total",2577,2026,1118,908,3,393,321,72,132,110,1,20,1,23
"2011","Leeds 014","E02002343","Total",2419,1980,866,1114,9,147,129,18,257,228,0,25,4,26
"2011","Leeds 015","E02002344","Total",3427,2634,1337,1297,45,178,71,107,531,488,5,35,3,39
"2011","Leeds 016","E02002345","Total",2334,1984,1096,888,2,115,99,16,212,199,0,12,1,21
"2011","Leeds 017","E02002346","Total",2727,1598,718,880,3,873,719,154,222,190,1,24,7,31
"2011","Leeds 018","E02002347","Total",2734,1251,539,712,16,1199,1021,178,198,169,1,23,5,70
"2011","Leeds 019","E02002348","Total",2727,1695,825,870,9,723,639,84,243,216,2,21,4,57
"2011","Leeds 020","E02002349","Total",2540,1738,917,821,7,228,101,127,536,503,6,20,7,31
"2011","Leeds 021","E02002350","Total",2563,2128,1226,902,17,81,28,53,304,242,0,12,50,33
"2011","Leeds 022","E02002351","Total",2265,1998,1092,906,1,91,66,25,151,138,2,11,0,24
"2011","Leeds 023","E02002352","Total",3116,2330,1139,1191,7,151,48,103,585,554,4,23,4,43
"2011","Leeds 024","E02002353","Total",2225,1763,748,1015,7,192,104,88,239,212,1,25,1,24
"2011","Leeds 025","E02002354","Total",3328,2205,1027,1178,11,696,427,269,366,324,2,35,5,50
"2011","Leeds 027","E02002356","Total",3217,2461,1193,1268,7,256,211,45,450,412,6,29,3,43
"2011","Leeds 028","E02002357","Total",3585,2220,955,1265,12,708,623,85,591,546,0,39,6,54
"2011","Leeds 029","E02002358","Total",3159,2066,829,1237,6,829,621,208,191,163,1,24,3,67
"2011","Leeds 030","E02002359","Total",2773,2149,1119,1030,13,295,256,39,262,235,4,16,7,54
"2011","Leeds 031","E02002360","Total",2954,1803,732,1071,7,624,157,467,477,437,2,31,7,43
"2011","Leeds 032","E02002361","Total",2462,1595,701,894,9,495,455,40,329,316,0,11,2,34
"2011","Leeds 033","E02002362","Total",3562,1562,651,911,12,1578,1437,141,340,300,0,34,6,70
"2011","Leeds 034","E02002363","Total",3300,2082,856,1226,14,238,118,120,939,907,0,28,4,27
"2011","Leeds 035","E02002364","Total",2699,920,323,597,5,1564,1481,83,133,113,0,19,1,77
"2011","Leeds 037","E02002366","Total",2844,2065,1075,990,4,260,52,208,475,438,2,33,2,40
"2011","Leeds 038","E02002367","Total",2603,859,281,578,13,1398,1061,337,285,260,1,20,4,48
"2011","Leeds 039","E02002368","Total",3537,2715,1156,1559,17,265,239,26,490,450,0,32,8,50
"2011","Leeds 040","E02002369","Total",2928,1227,470,757,10,1383,1219,164,252,233,0,14,5,56
"2011","Leeds 041","E02002370","Total",2880,1321,419,902,18,1284,1016,268,208,175,1,30,2,49
"2011","Leeds 042","E02002371","Total",4149,1779,842,937,10,1451,761,690,822,768,0,49,5,87
"2011","Leeds 044","E02002373","Total",2670,531,265,266,7,289,99,190,1826,1784,1,34,7,17
"2011","Leeds 045","E02002374","Total",2979,1279,614,665,34,853,641,212,763,714,7,30,12,50
"2011","Leeds 046","E02002375","Total",2296,1023,352,671,11,1026,929,97,207,168,1,21,17,29
"2011","Leeds 047","E02002376","Total",2455,913,379,534,18,1212,1017,195,262,240,2,17,3,50
"2011","Leeds 048","E02002377","Total",2282,880,423,457,6,575,196,379,769,734,0,28,7,52
"2011","Leeds 050","E02002379","Total",2044,756,286,470,4,1120,951,169,122,99,1,14,8,42
"2011","Leeds 051","E02002380","Total",2353,1676,718,958,8,431,405,26,202,178,1,21,2,36
"2011","Leeds 052","E02002381","Total",2891,1771,584,1187,1,582,443,139,499,454,1,30,14,38
"2011","Leeds 053","E02002382","Total",2302,869,384,485,3,394,267,127,975,939,4,26,6,61
"2011","Leeds 054","E02002383","Total",2332,307,170,137,9,377,137,240,1620,1581,4,24,11,19
"2011","Leeds 055","E02002384","Total",4306,536,228,308,23,2179,1589,590,1470,1399,6,29,36,98
"2011","Leeds 056","E02002385","Total",3419,982,420,562,14,820,549,271,1556,1479,2,67,8,47
"2011","Leeds 057","E02002386","Total",3853,3283,1824,1459,5,111,82,29,419,393,0,23,3,35
"2011","Leeds 058","E02002387","Total",2435,1189,424,765,25,820,673,147,355,316,1,32,6,46
"2011","Leeds 059","E02002388","Total",3196,1700,621,1079,18,984,773,211,467,422,0,43,2,27
"2011","Leeds 060","E02002389","Total",2906,869,300,569,10,1745,1498,247,211,193,0,9,9,71
"2011","Leeds 061","E02002390","Total",2665,1554,604,950,24,794,394,400,252,230,0,20,2,41
"2011","Leeds 062","E02002391","Total",3505,2473,925,1548,6,466,437,29,509,449,8,50,2,51
"2011","Leeds 063","E02002392","Total",2352,260,132,128,6,667,346,321,1394,1353,7,18,16,25
"2011","Leeds 064","E02002393","Total",3870,390,191,199,38,2334,1863,471,1004,952,19,19,14,104
"2011","Leeds 065","E02002394","Total",3198,954,373,581,9,1344,1154,190,825,791,4,26,4,66
"2011","Leeds 066","E02002395","Total",2440,1961,975,986,13,116,87,29,331,301,0,28,2,19
"2011","Leeds 067","E02002396","Total",3822,2325,902,1423,13,597,370,227,848,786,4,52,6,39
"2011","Leeds 068","E02002397","Total",3277,2037,825,1212,37,840,769,71,308,272,0,33,3,55
"2011","Leeds 069","E02002398","Total",3256,2730,1432,1298,10,165,110,55,316,285,1,30,0,35
"2011","Leeds 070","E02002399","Total",2631,1490,573,917,4,670,650,20,430,384,1,43,2,37
"2011","Leeds 071","E02002400","Total",3641,1095,426,669,18,1499,1302,197,953,921,2,24,6,76
"2011","Leeds 072","E02002401","Total",2541,748,351,397,4,1581,1136,445,172,155,2,9,6,36
"2011","Leeds 073","E02002402","Total",2396,2118,960,1158,2,31,23,8,221,201,1,17,2,24
"2011","Leeds 074","E02002403","Total",2633,1895,945,950,4,318,259,59,376,350,3,22,1,40
"2011","Leeds 075","E02002404","Total",4432,1005,307,698,46,1468,942,526,1837,1789,3,38,7,76
"2011","Leeds 076","E02002405","Total",3228,2366,1140,1226,6,380,293,87,423,371,2,45,5,53
"2011","Leeds 077","E02002406","Total",2850,2565,1287,1278,7,107,66,41,152,139,0,13,0,19
"2011","Leeds 078","E02002407","Total",2835,1061,337,724,14,1300,1253,47,403,368,3,27,5,57
"2011","Leeds 079","E02002408","Total",3268,2077,796,1281,33,621,562,59,477,447,0,27,3,60
"2011","Leeds 080","E02002409","Total",2633,1607,730,877,18,760,717,43,213,181,1,31,0,35
"2011","Leeds 081","E02002410","Total",3051,2026,866,1160,33,559,358,201,395,360,4,26,5,38
"2011","Leeds 082","E02002411","Total",3502,924,353,571,6,887,653,234,1625,1580,0,37,8,60
"2011","Leeds 083","E02002412","Total",3051,2202,852,1350,8,369,280,89,440,402,0,34,4,32
"2011","Leeds 085","E02002414","Total",2682,745,275,470,22,1126,864,262,707,681,0,18,8,82
"2011","Leeds 086","E02002415","Total",2599,739,339,400,9,701,302,399,1108,1063,1,19,25,42
"2011","Leeds 087","E02002416","Total",2794,1983,1121,862,9,569,543,26,192,173,3,15,1,41
"2011","Leeds 088","E02002417","Total",2727,1946,842,1104,35,386,324,62,331,308,3,13,7,29
"2011","Leeds 089","E02002418","Total",3038,2375,925,1450,7,427,349,78,201,174,1,25,1,28
"2011","Leeds 090","E02002419","Total",3503,1545,664,881,5,1455,1292,163,431,391,0,36,4,67
"2011","Leeds 091","E02002420","Total",3299,2284,1029,1255,23,230,189,41,711,658,0,52,1,51
"2011","Leeds 092","E02002421","Total",2609,756,274,482,14,1591,1127,464,190,171,1,8,10,58
"2011","Leeds 093","E02002422","Total",2662,2194,951,1243,3,150,112,38,275,247,0,28,0,40
"2011","Leeds 094","E02002423","Total",2482,1323,537,786,14,886,793,93,213,186,1,24,2,46
"2011","Leeds 095","E02002424","Total",3271,2364,897,1467,8,515,420,95,344,313,0,29,2,40
"2011","Leeds 096","E02002425","Total",3685,2818,1297,1521,21,350,310,40,447,403,2,38,4,49
"2011","Leeds 097","E02002426","Total",3240,2460,1101,1359,8,420,350,70,317,287,3,22,5,35
"2011","Leeds 098","E02002427","Total",3021,1994,961,1033,4,742,559,183,240,218,2,16,4,41
"2011","Leeds 099","E02002428","Total",3110,1982,725,1257,55,628,558,70,407,358,4,43,2,38
"2011","Leeds 100","E02002429","Total",3523,2592,1021,1571,7,473,417,56,401,372,5,18,6,50
"2011","Leeds 101","E02002430","Total",3017,1099,360,739,3,1601,1391,210,247,217,1,23,6,67
"2011","Leeds 102","E02002431","Total",3591,2188,670,1518,17,632,557,75,703,663,1,36,3,51
"2011","Leeds 103","E02002432","Total",2919,2200,896,1304,11,446,414,32,221,198,0,20,3,41
"2011","Leeds 104","E02002433","Total",3182,1657,589,1068,26,715,441,274,737,686,1,44,6,47
"2011","Leeds 105","E02002434","Total",3542,2511,668,1843,48,530,392,138,423,381,1,38,3,30
"2011","Leeds 106","E02002435","Total",3269,2482,1099,1383,5,188,111,77,557,516,2,37,2,37
"2011","Leeds 107","E02002436","Total",2831,1837,739,1098,12,586,464,122,343,303,5,34,1,53
"2011","Leeds 108","E02002437","Total",2445,2162,890,1272,7,81,73,8,179,162,0,14,3,16
"2011","Leeds 109","E02006852","Total",4551,2845,1405,1440,10,191,83,108,1441,1339,12,52,38,64
"2011","Leeds 110","E02006861","Total",3887,736,363,373,25,605,145,460,2475,2358,15,57,45,46
"2011","Leeds 111","E02006875","Total",3569,669,194,475,22,169,10,159,2658,2569,8,53,28,51
"2011","Leeds 112","E02006876","Total",3492,946,315,631,13,878,657,221,1598,1552,2,28,16,57
"2011","Wakefield 001","E02002438","Total",3273,1558,676,882,6,1476,1180,296,196,166,2,23,5,37
"2011","Wakefield 002","E02002439","Total",3639,2291,1094,1197,16,551,429,122,744,675,7,55,7,37
"2011","Wakefield 003","E02002440","Total",3225,2037,939,1098,16,971,804,167,168,144,0,23,1,33
"2011","Wakefield 004","E02002441","Total",3825,2209,932,1277,33,1186,855,331,365,332,2,28,3,32
"2011","Wakefield 005","E02002442","Total",2819,2251,957,1294,4,139,86,53,404,375,0,26,3,21
"2011","Wakefield 006","E02002443","Total",2353,1994,752,1242,8,124,91,33,208,183,1,23,1,19
"2011","Wakefield 007","E02002444","Total",2657,1855,781,1074,20,464,336,128,305,260,6,34,5,13
"2011","Wakefield 008","E02002445","Total",3057,2164,1040,1124,5,552,383,169,305,260,2,42,1,31
"2011","Wakefield 009","E02002446","Total",2585,1999,937,1062,3,328,239,89,236,209,2,25,0,19
"2011","Wakefield 010","E02002447","Total",2721,1633,722,911,13,735,548,187,314,292,0,19,3,26
"2011","Wakefield 011","E02002448","Total",3352,1736,828,908,34,1283,1051,232,281,245,4,25,7,18
"2011","Wakefield 012","E02002449","Total",3230,2557,1028,1529,28,336,129,207,282,263,4,15,0,27
"2011","Wakefield 013","E02002450","Total",2859,2102,793,1309,20,429,290,139,280,247,2,26,5,28
"2011","Wakefield 014","E02002451","Total",3049,2446,1274,1172,3,400,228,172,175,148,1,24,2,25
"2011","Wakefield 015","E02002452","Total",3723,1775,697,1078,20,1416,999,417,472,422,2,34,14,40
"2011","Wakefield 016","E02002453","Total",4171,2231,922,1309,15,1376,1020,356,514,460,3,41,10,35
"2011","Wakefield 017","E02002454","Total",3399,1298,539,759,24,994,601,393,1037,980,0,41,16,46
"2011","Wakefield 018","E02002455","Total",2552,1249,523,726,16,1116,901,215,152,128,2,18,4,19
"2011","Wakefield 019","E02002456","Total",2738,1558,718,840,7,498,380,118,642,596,4,36,6,33
"2011","Wakefield 020","E02002457","Total",3252,1371,562,809,6,1516,1112,404,320,290,3,21,6,39
"2011","Wakefield 021","E02002458","Total",3757,2642,1185,1457,7,565,455,110,514,463,5,38,8,29
"2011","Wakefield 022","E02002459","Total",3934,2335,859,1476,22,1080,795,285,465,420,2,37,6,32
"2011","Wakefield 023","E02002460","Total",3149,2551,1461,1090,15,308,169,139,245,218,2,23,2,30
"2011","Wakefield 024","E02002461","Total",4173,2915,1170,1745,7,841,668,173,382,327,9,41,5,28
"2011","Wakefield 025","E02002462","Total",3337,2186,1037,1149,8,731,397,334,379,347,1,27,4,33
"2011","Wakefield 026","E02002463","Total",3651,1193,482,711,13,2234,1712,522,177,144,1,16,16,34
"2011","Wakefield 027","E02002464","Total",3506,1925,873,1052,11,1150,917,233,386,331,1,46,8,34
"2011","Wakefield 028","E02002465","Total",2850,1920,1089,831,1,521,398,123,372,348,1,19,4,36
"2011","Wakefield 029","E02002466","Total",4012,2605,1177,1428,23,970,720,250,366,327,2,34,3,48
"2011","Wakefield 030","E02002467","Total",3611,1558,671,887,59,1042,725,317,917,864,10,34,9,35
"2011","Wakefield 031","E02002468","Total",2660,1975,918,1057,4,276,179,97,378,336,1,33,8,27
"2011","Wakefield 032","E02002469","Total",2423,1890,918,972,3,347,270,77,156,133,3,18,2,27
"2011","Wakefield 033","E02002470","Total",2622,2336,1395,941,27,93,52,41,142,125,3,11,3,24
"2011","Wakefield 034","E02002471","Total",4499,3611,1860,1751,15,394,236,158,438,376,12,44,6,41
"2011","Wakefield 035","E02002472","Total",2439,1869,938,931,7,324,226,98,221,196,0,15,10,18
"2011","Wakefield 036","E02002473","Total",2722,2338,1142,1196,2,84,17,67,275,247,4,21,3,23
"2011","Wakefield 037","E02002474","Total",2700,1444,641,803,31,1017,728,289,182,156,1,24,1,26
"2011","Wakefield 038","E02002475","Total",2573,2078,1076,1002,43,222,148,74,204,177,4,19,4,26
"2011","Wakefield 039","E02002476","Total",2375,1188,557,631,8,873,663,210,270,249,2,17,2,36
"2011","Wakefield 040","E02002477","Total",2699,1722,751,971,2,632,436,196,307,270,1,34,2,36
"2011","Wakefield 041","E02002478","Total",2459,1748,761,987,5,295,219,76,385,348,0,34,3,26
"2011","Wakefield 042","E02002479","Total",3693,2283,1057,1226,21,925,666,259,427,381,3,33,10,37
"2011","Wakefield 043","E02002480","Total",2673,1565,769,796,6,602,445,157,476,434,4,35,3,24
"2011","Wakefield 044","E02002481","Total",2672,1617,677,940,4,726,520,206,308,273,3,29,3,17
"2011","Wakefield 045","E02002482","Total",2746,1483,588,895,9,987,713,274,245,218,0,20,7,22
"2011","Derby 001","E02002796","Total",2585,2261,1286,975,30,88,83,5,189,168,0,19,2,17
"2011","Derby 002","E02002797","Total",3371,3044,1944,1100,3,28,11,17,272,248,2,18,4,24
"2011","Derby 003","E02002798","Total",4187,3530,1272,2258,10,50,18,32,572,525,4,38,5,25
"2011","Derby 004","E02002799","Total",2451,1434,614,820,18,668,547,121,305,275,1,28,1,26
"2011","Derby 005","E02002800","Total",3136,2111,1010,1101,25,384,113,271,586,558,0,21,7,30
"2011","Derby 006","E02002801","Total",3160,2340,1108,1232,4,486,410,76,290,253,0,34,3,40
"2011","Derby 007","E02002802","Total",3256,1434,613,821,11,1422,1303,119,335,303,0,27,5,54
"2011","Derby 008","E02002803","Total",3492,1151,458,693,114,1065,588,477,1126,1070,3,42,11,36
"2011","Derby 009","E02002804","Total",3243,1992,994,998,5,980,878,102,210,175,0,33,2,56
"2011","Derby 010","E02002805","Total",2575,2257,1306,951,14,93,42,51,189,167,1,21,0,22
"2011","Derby 011","E02002806","Total",2839,998,422,576,21,674,332,342,1109,1056,3,43,7,37
"2011","Derby 012","E02002807","Total",3737,2671,1262,1409,10,710,644,66,304,267,1,34,2,42
"2011","Derby 013","E02002808","Total",5590,1431,592,839,103,1601,500,1101,2397,2271,12,90,24,58
"2011","Derby 014","E02002809","Total",2830,1947,925,1022,34,540,392,148,283,244,2,34,3,26
"2011","Derby 015","E02002810","Total",3457,3013,1690,1323,27,116,16,100,276,251,1,21,3,25
"2011","Derby 016","E02002811","Total",3684,1459,720,739,13,815,282,533,1319,1250,6,41,22,78
"2011","Derby 017","E02002812","Total",2722,1870,962,908,8,426,279,147,387,353,11,20,3,31
"2011","Derby 018","E02002813","Total",3819,1244,718,526,42,1215,449,766,1209,1164,2,24,19,109
"2011","Derby 019","E02002814","Total",3273,2719,1507,1212,4,214,102,112,296,262,4,26,4,40
"2011","Derby 020","E02002815","Total",2520,1487,781,706,12,298,60,238,682,634,1,39,8,41
"2011","Derby 021","E02002816","Total",3377,2549,1056,1493,69,340,25,315,394,367,7,17,3,25
"2011","Derby 022","E02002817","Total",2377,2031,1150,881,2,130,122,8,198,166,2,29,1,16
"2011","Derby 023","E02002818","Total",2852,1343,610,733,12,998,727,271,464,433,0,24,7,35
"2011","Derby 024","E02002819","Total",3452,2078,848,1230,68,541,328,213,734,679,3,41,11,31
"2011","Derby 025","E02002820","Total",4043,2348,942,1406,11,875,701,174,754,693,3,53,5,55
"2011","Derby 026","E02002821","Total",4340,1620,640,980,26,1866,1416,450,776,719,1,43,13,52
"2011","Derby 027","E02002822","Total",2748,1883,954,929,34,540,329,211,273,250,1,19,3,18
"2011","Derby 028","E02002823","Total",3236,2151,1107,1044,7,797,449,348,246,211,0,28,7,35
"2011","Derby 029","E02002824","Total",3716,1920,816,1104,27,1332,889,443,391,353,2,33,3,46
"2011","Derby 030","E02002825","Total",3557,2535,1101,1434,72,524,276,248,377,343,1,29,4,49
"2011","Derby 031","E02002826","Total",2646,1914,831,1083,28,434,147,287,250,235,1,13,1,20
"2011","Leicester 001","E02002827","Total",2550,1495,476,1019,20,737,600,137,279,266,2,10,1,19
"2011","Leicester 002","E02002828","Total",2804,2233,1062,1171,12,95,23,72,439,394,1,38,6,25
"2011","Leicester 003","E02002829","Total",4340,1752,689,1063,14,1975,1623,352,515,458,7,41,9,84
"2011","Leicester 004","E02002830","Total",3909,1616,491,1125,17,1758,1070,688,475,415,22,23,15,43
"2011","Leicester 005","E02002831","Total",2340,1685,870,815,5,184,139,45,429,400,1,21,7,37
"2011","Leicester 006","E02002832","Total",2803,1458,853,605,11,624,231,393,651,585,4,39,23,59
"2011","Leicester 007","E02002833","Total",2609,1379,744,635,5,633,65,568,555,507,2,32,14,37
"2011","Leicester 008","E02002834","Total",3975,2783,1393,1390,83,239,48,191,838,785,2,45,6,32
"2011","Leicester 009","E02002835","Total",4369,2840,828,2012,93,472,110,362,940,894,2,35,9,24
"2011","Leicester 010","E02002836","Total",3131,1611,888,723,14,788,405,383,665,621,1,37,6,53
"2011","Leicester 011","E02002837","Total",2624,1032,405,627,7,1053,955,98,496,463,0,26,7,36
"2011","Leicester 012","E02002838","Total",3093,1094,453,641,28,1679,1526,153,242,227,1,13,1,50
"2011","Leicester 013","E02002839","Total",2911,1874,821,1053,26,691,590,101,272,233,0,27,12,48
"2011","Leicester 016","E02002842","Total",3418,1205,454,751,33,524,223,301,1587,1517,3,53,14,69
"2011","Leicester 017","E02002843","Total",3843,1634,904,730,16,911,396,515,1206,1151,9,27,19,76
"2011","Leicester 018","E02002844","Total",3775,786,481,305,13,2424,1947,477,448,402,3,19,24,104
"2011","Leicester 019","E02002845","Total",3933,1805,764,1041,32,1356,1066,290,646,518,66,35,27,94
"2011","Leicester 020","E02002846","Total",3028,2422,1132,1290,4,134,108,26,437,393,2,40,2,31
"2011","Leicester 021","E02002847","Total",2854,1982,1043,939,9,136,106,30,667,612,4,38,13,60
"2011","Leicester 022","E02002848","Total",3344,1353,823,530,19,783,196,587,1130,1069,6,42,13,59
"2011","Leicester 023","E02002849","Total",5256,1610,697,913,41,702,278,424,2822,2724,10,64,24,81
"2011","Leicester 025","E02002851","Total",2861,2398,1331,1067,11,182,169,13,244,228,1,10,5,26
"2011","Leicester 026","E02002852","Total",2584,638,187,451,13,1780,1424,356,106,91,0,13,2,47
"2011","Leicester 027","E02002853","Total",4029,2338,1324,1014,13,423,144,279,1186,1132,4,38,12,69
"2011","Leicester 028","E02002854","Total",3222,1354,442,912,27,1332,1099,233,449,413,1,31,4,60
"2011","Leicester 029","E02002855","Total",2786,1531,679,852,12,96,60,36,1113,1039,2,51,21,34
"2011","Leicester 030","E02002856","Total",5066,2536,1258,1278,23,249,58,191,2205,2107,1,84,13,53
"2011","Leicester 031","E02002857","Total",2925,1489,538,951,20,332,177,155,1054,997,3,47,7,30
"2011","Leicester 032","E02002858","Total",2928,2353,1235,1118,7,65,24,41,468,441,3,22,2,35
"2011","Leicester 034","E02002860","Total",3350,2343,1091,1252,13,530,385,145,410,371,3,31,5,54
"2011","Leicester 035","E02002861","Total",2775,913,361,552,10,1638,1380,258,157,141,0,10,6,57
"2011","Leicester 036","E02002862","Total",3547,1616,599,1017,13,1589,1495,94,246,219,1,21,5,83
"2011","Leicester 037","E02006815","Total",3739,2026,980,1046,9,1355,1283,72,268,239,4,21,4,81
"2011","Leicester 038","E02006817","Total",2974,1973,953,1020,17,398,199,199,555,504,2,32,17,31
"2011","Leicester 039","E02006819","Total",3254,1349,498,851,44,1552,1219,333,259,226,4,21,8,50
"2011","Leicester 040","E02006850","Total",3215,390,201,189,17,1209,189,1020,1549,1474,15,15,45,50
"2011","Leicester 041","E02006851","Total",2961,274,70,204,23,642,38,604,1991,1951,6,21,13,31
"2011","Nottingham 001","E02002868","Total",2458,1932,1003,929,27,322,198,124,158,137,0,19,2,19
"2011","Nottingham 002","E02002869","Total",3297,1396,558,838,15,1316,1079,237,515,482,0,29,4,55
"2011","Nottingham 004","E02002871","Total",3469,2255,990,1265,9,632,462,170,537,492,2,41,2,36
"2011","Nottingham 005","E02002872","Total",3816,1736,678,1058,16,1558,1282,276,455,425,0,26,4,51
"2011","Nottingham 006","E02002873","Total",3903,1813,679,1134,8,1427,1306,121,599,565,0,32,2,56
"2011","Nottingham 007","E02002874","Total",3052,1846,814,1032,9,784,695,89,362,322,6,33,1,51
"2011","Nottingham 008","E02002875","Total",3627,1676,563,1113,37,1192,803,389,673,619,2,47,5,49
"2011","Nottingham 009","E02002876","Total",3471,2023,762,1261,36,816,513,303,556,519,2,31,4,40
"2011","Nottingham 010","E02002877","Total",3650,2209,1043,1166,24,347,194,153,1020,949,2,60,9,50
"2011","Nottingham 011","E02002878","Total",3258,1066,374,692,5,1746,1648,98,392,367,0,21,4,49
"2011","Nottingham 012","E02002879","Total",3936,2153,765,1388,20,598,129,469,1124,1076,1,39,8,41
"2011","Nottingham 013","E02002880","Total",3296,1348,448,900,7,1418,1315,103,470,440,0,28,2,53
"2011","Nottingham 014","E02002881","Total",2669,1153,475,678,4,1209,856,353,250,215,1,17,17,53
"2011","Nottingham 015","E02002882","Total",3784,1788,843,945,18,414,146,268,1520,1464,4,47,5,44
"2011","Nottingham 016","E02002883","Total",3537,1561,571,990,43,1137,404,733,753,707,5,33,8,43
"2011","Nottingham 017","E02002884","Total",2323,902,397,505,8,333,53,280,1051,1015,1,24,11,29
"2011","Nottingham 018","E02002885","Total",3107,763,306,457,21,969,453,516,1285,1234,8,26,17,69
"2011","Nottingham 019","E02002886","Total",3438,2079,1042,1037,29,733,552,181,544,492,2,36,14,53
"2011","Nottingham 020","E02002887","Total",2832,1315,612,703,29,1191,1055,136,223,196,2,23,2,74
"2011","Nottingham 021","E02002888","Total",3064,1036,402,634,10,1522,1370,152,403,366,0,33,4,93
"2011","Nottingham 022","E02002889","Total",3140,316,143,173,32,1450,163,1287,1317,1254,12,23,28,25
"2011","Nottingham 023","E02002890","Total",4727,646,303,343,26,2225,1655,570,1740,1667,6,28,39,90
"2011","Nottingham 024","E02002891","Total",3376,2284,1078,1206,12,621,550,71,409,361,1,45,2,50
"2011","Nottingham 025","E02002892","Total",2565,1382,623,759,4,929,761,168,206,185,0,21,0,44
"2011","Nottingham 026","E02002893","Total",4388,839,376,463,33,1709,948,761,1741,1668,2,46,25,66
"2011","Nottingham 027","E02002894","Total",2689,2072,983,1089,1,222,104,118,374,349,2,20,3,20
"2011","Nottingham 028","E02002895","Total",3279,1017,545,472,6,390,172,218,1834,1771,5,49,9,32
"2011","Nottingham 029","E02002896","Total",4372,1316,477,839,13,1483,793,690,1495,1418,4,67,6,65
"2011","Nottingham 030","E02002897","Total",3406,2627,1609,1018,8,443,116,327,290,267,1,18,4,38
"2011","Nottingham 031","E02002898","Total",3738,735,415,320,12,880,661,219,2058,1988,8,48,14,53
"2011","Nottingham 032","E02002899","Total",2172,945,508,437,7,619,483,136,548,441,31,35,41,53
"2011","Nottingham 034","E02002901","Total",2540,1910,998,912,7,323,257,66,275,241,2,30,2,25
"2011","Nottingham 035","E02002902","Total",3488,2034,976,1058,8,1044,907,137,352,304,1,39,8,50
"2011","Nottingham 036","E02002903","Total",2859,1446,656,790,179,948,666,282,242,199,1,36,6,44
"2011","Nottingham 037","E02002904","Total",2633,1667,739,928,2,675,627,48,247,210,3,31,3,42
"2011","Nottingham 038","E02006834","Total",3661,1649,680,969,9,1659,1398,261,278,238,3,30,7,66
"2011","Nottingham 039","E02006904","Total",3787,820,294,526,30,836,340,496,2044,1963,15,41,25,57
"2011","Nottingham 040","E02006905","Total",3324,1112,424,688,22,1366,1062,304,758,694,1,51,12,66
"2011","Rutland 001","E02002863","Total",2676,1688,935,753,25,265,56,209,640,297,207,14,122,58
"2011","Rutland 002","E02002864","Total",2519,1829,1027,802,42,314,96,218,305,276,7,19,3,29
"2011","Rutland 003","E02002865","Total",3390,2355,1329,1026,43,428,69,359,497,453,6,27,11,67
"2011","Rutland 004","E02002866","Total",3088,2334,1274,1060,23,285,51,234,409,306,50,29,24,37
"2011","Rutland 005","E02002867","Total",3329,2350,1324,1026,27,393,97,296,482,409,31,33,9,77
"2011","Amber Valley 001","E02004029","Total",2845,1802,933,869,5,594,220,374,395,358,2,30,5,49
"2011","Amber Valley 002","E02004030","Total",2550,1975,1204,771,8,278,108,170,248,208,4,28,8,41
"2011","Amber Valley 003","E02004031","Total",3218,1524,692,832,3,1209,498,711,415,363,1,29,22,67
"2011","Amber Valley 004","E02004032","Total",3643,3051,1638,1413,12,202,81,121,339,306,1,31,1,39
"2011","Amber Valley 005","E02004033","Total",3828,2882,1381,1501,32,252,108,144,615,563,7,43,2,47
"2011","Amber Valley 006","E02004034","Total",3197,2652,1510,1142,7,259,85,174,246,213,0,31,2,33
"2011","Amber Valley 007","E02004035","Total",2727,2300,1386,914,12,133,67,66,249,218,8,16,7,33
"2011","Amber Valley 008","E02004036","Total",4267,2934,1544,1390,15,817,357,460,440,399,4,34,3,61
"2011","Amber Valley 009","E02004037","Total",3154,2709,1307,1402,28,126,30,96,269,245,0,17,7,22
"2011","Amber Valley 010","E02004038","Total",3643,2505,1229,1276,16,381,180,201,683,622,6,44,11,58
"2011","Amber Valley 011","E02004039","Total",3413,2747,1267,1480,20,225,113,112,389,361,2,22,4,32
"2011","Amber Valley 012","E02004040","Total",3658,2907,1347,1560,15,238,110,128,457,430,2,24,1,41
"2011","Amber Valley 013","E02004041","Total",2938,2322,1051,1271,1,219,92,127,363,332,2,26,3,33
"2011","Amber Valley 015","E02004043","Total",3009,2306,1213,1093,6,437,173,264,218,196,2,19,1,42
"2011","Amber Valley 016","E02004044","Total",3151,2501,1506,995,22,189,69,120,386,364,5,13,4,53
"2011","Amber Valley 017","E02006827","Total",3355,1857,898,959,14,925,417,508,488,440,5,34,9,71
"2011","Bolsover 001","E02004045","Total",3899,2992,1438,1554,4,358,301,57,503,455,0,45,3,42
"2011","Bolsover 002","E02004046","Total",2738,1866,933,933,6,572,523,49,255,220,4,27,4,39
"2011","Bolsover 003","E02004047","Total",2507,1320,626,694,4,639,463,176,506,463,8,32,3,38
"2011","Bolsover 004","E02004048","Total",2919,1792,863,929,3,561,451,110,524,479,2,39,4,39
"2011","Bolsover 005","E02004049","Total",3478,2509,1314,1195,4,640,555,85,265,229,3,32,1,60
"2011","Bolsover 006","E02004050","Total",2969,1689,880,809,25,911,762,149,281,251,0,29,1,63
"2011","Bolsover 007","E02004051","Total",3831,2331,1196,1135,12,703,474,229,712,661,3,43,5,73
"2011","Bolsover 008","E02004052","Total",3382,2453,1182,1271,16,544,533,11,309,268,4,32,5,60
"2011","Bolsover 009","E02004053","Total",3347,2159,954,1205,14,680,561,119,440,400,1,33,6,54
"2011","Bolsover 010","E02004054","Total",3731,2852,1305,1547,4,357,299,58,481,445,2,32,2,37
"2011","Chesterfield 001","E02004055","Total",3286,2129,1096,1033,13,750,649,101,361,331,2,23,5,33
"2011","Chesterfield 002","E02004056","Total",3228,1582,746,836,3,1353,1325,28,267,243,1,22,1,23
"2011","Chesterfield 003","E02004057","Total",3398,2087,846,1241,11,703,502,201,568,520,1,40,7,29
"2011","Chesterfield 004","E02004058","Total",3638,1763,900,863,6,1538,1494,44,292,254,2,31,5,39
"2011","Chesterfield 005","E02004059","Total",3232,2408,1250,1158,3,551,479,72,245,218,1,24,2,25
"2011","Chesterfield 006","E02004060","Total",3190,2102,1082,1020,3,813,608,205,248,226,0,18,4,24
"2011","Chesterfield 007","E02004061","Total",3430,2055,1088,967,4,878,763,115,457,418,1,33,5,36
"2011","Chesterfield 008","E02004062","Total",3680,2274,1073,1201,43,1175,1056,119,154,137,1,14,2,34
"2011","Chesterfield 009","E02004063","Total",3655,2799,1534,1265,5,392,340,52,423,385,4,30,4,36
"2011","Chesterfield 010","E02004064","Total",4271,2023,898,1125,21,631,434,197,1541,1440,4,76,21,55
"2011","Chesterfield 011","E02004065","Total",3672,3374,1993,1381,8,30,25,5,225,191,1,28,5,35
"2011","Chesterfield 012","E02004066","Total",5124,3721,1886,1835,33,515,320,195,805,721,19,54,11,50
"2011","Chesterfield 013","E02004067","Total",2992,1230,673,557,3,1503,1390,113,227,207,1,18,1,29
"2011","Derbyshire Dales 001","E02004068","Total",3302,2393,1486,907,33,416,132,284,409,348,4,51,6,51
"2011","Derbyshire Dales 002","E02004069","Total",3099,2210,1483,727,19,215,68,147,491,413,29,25,24,164
"2011","Derbyshire Dales 003","E02004070","Total",2763,1967,1332,635,23,410,170,240,308,261,7,34,6,55
"2011","Derbyshire Dales 004","E02004071","Total",2229,1624,958,666,8,298,118,180,259,228,12,13,6,40
"2011","Derbyshire Dales 005","E02004072","Total",3722,3031,1770,1261,18,238,72,166,391,350,6,30,5,44
"2011","Derbyshire Dales 006","E02004073","Total",4129,2767,1651,1116,8,821,258,563,475,420,7,41,7,58
"2011","Derbyshire Dales 007","E02004074","Total",2582,1931,1153,778,13,350,124,226,256,240,0,12,4,32
"2011","Derbyshire Dales 008","E02004075","Total",3156,2357,1458,899,25,199,79,120,493,451,5,33,4,82
"2011","Derbyshire Dales 009","E02004076","Total",2796,1731,860,871,72,673,267,406,285,267,2,12,4,35
"2011","Derbyshire Dales 010","E02004077","Total",2966,2258,1362,896,10,116,42,74,493,445,14,25,9,89
"2011","Erewash 001","E02004078","Total",3159,1621,766,855,5,1063,420,643,409,366,0,28,15,61
"2011","Erewash 003","E02004080","Total",4284,2725,1266,1459,16,483,155,328,1005,942,0,50,13,55
"2011","Erewash 004","E02004081","Total",2470,1953,1080,873,1,287,56,231,199,178,2,15,4,30
"2011","Erewash 005","E02004082","Total",2550,2316,1224,1092,7,49,15,34,154,133,0,16,5,24
"2011","Erewash 006","E02004083","Total",3310,2501,1120,1381,20,313,85,228,448,422,0,18,8,28
"2011","Erewash 007","E02004084","Total",2667,1733,897,836,5,725,265,460,167,154,0,11,2,37
"2011","Erewash 008","E02004085","Total",3726,2769,1358,1411,7,486,153,333,422,382,4,32,4,42
"2011","Erewash 009","E02004086","Total",3175,2445,1271,1174,19,341,102,239,331,297,3,30,1,39
"2011","Erewash 010","E02004087","Total",3414,2306,980,1326,26,553,173,380,496,453,0,40,3,33
"2011","Erewash 011","E02004088","Total",3124,2748,1321,1427,6,39,2,37,290,265,3,21,1,41
"2011","Erewash 012","E02004089","Total",3259,1773,641,1132,26,600,147,453,819,774,6,34,5,41
"2011","Erewash 013","E02004090","Total",2733,2038,1056,982,15,342,113,229,305,281,2,19,3,33
"2011","Erewash 014","E02004091","Total",3905,3169,1429,1740,19,154,32,122,533,488,7,37,1,30
"2011","Erewash 015","E02004092","Total",4194,2931,1272,1659,49,764,212,552,403,367,4,24,8,47
"2011","Erewash 016","E02006828","Total",2722,2262,825,1437,21,136,48,88,284,260,0,23,1,19
"2011","High Peak 001","E02004093","Total",2751,1980,804,1176,16,321,220,101,412,382,0,26,4,22
"2011","High Peak 002","E02004094","Total",2994,1711,675,1036,10,997,918,79,225,197,1,23,4,51
"2011","High Peak 003","E02004095","Total",4463,2882,1239,1643,18,661,515,146,830,756,4,67,3,72
"2011","High Peak 004","E02004096","Total",3795,3420,1612,1808,12,75,69,6,256,222,1,26,7,32
"2011","High Peak 005","E02004097","Total",3328,2704,1322,1382,6,103,76,27,491,450,0,28,13,24
"2011","High Peak 006","E02004098","Total",3227,2182,1073,1109,41,667,514,153,286,249,1,34,2,51
"2011","High Peak 008","E02004100","Total",3216,2589,1376,1213,9,195,177,18,381,342,2,34,3,42
"2011","High Peak 010","E02004102","Total",3909,2281,1256,1025,27,465,209,256,1087,1010,9,56,12,49
"2011","High Peak 011","E02004103","Total",2938,1746,840,906,19,779,600,179,361,316,2,37,6,33
"2011","High Peak 012","E02004104","Total",2912,2444,1263,1181,17,135,98,37,289,244,8,34,3,27
"2011","High Peak 013","E02006872","Total",5413,4120,2233,1887,54,547,440,107,613,538,9,49,17,79
"2011","North East Derbyshire 001","E02004105","Total",3845,2747,1152,1595,16,775,750,25,272,232,2,30,8,35
"2011","North East Derbyshire 002","E02004106","Total",3111,2637,1587,1050,4,233,211,22,205,182,1,21,1,32
"2011","North East Derbyshire 004","E02004108","Total",3387,2111,1083,1028,24,938,664,274,286,250,4,20,12,28
"2011","North East Derbyshire 005","E02004109","Total",2880,2510,1537,973,3,202,182,20,125,106,2,14,3,40
"2011","North East Derbyshire 006","E02004110","Total",3136,2822,1482,1340,32,139,104,35,122,106,1,13,2,21
"2011","North East Derbyshire 007","E02004111","Total",2414,1857,1074,783,4,354,226,128,170,149,2,14,5,29
"2011","North East Derbyshire 008","E02004112","Total",2894,2462,1582,880,8,199,163,36,199,173,2,19,5,26
"2011","North East Derbyshire 009","E02004113","Total",4027,1881,950,931,9,1777,1658,119,323,293,1,26,3,37
"2011","North East Derbyshire 010","E02004114","Total",3163,2681,1704,977,4,234,211,23,213,174,4,32,3,31
"2011","North East Derbyshire 011","E02004115","Total",3978,2947,1423,1524,22,614,592,22,369,334,1,32,2,26
"2011","North East Derbyshire 012","E02004116","Total",3604,1883,883,1000,25,1289,1224,65,368,327,4,30,7,39
"2011","North East Derbyshire 013","E02004117","Total",3170,2078,1167,911,0,824,752,72,232,203,3,23,3,36
"2011","North East Derbyshire 014","E02006804","Total",3461,1915,847,1068,17,1203,1080,123,299,271,6,18,4,27
"2011","South Derbyshire 001","E02004118","Total",2700,2128,1037,1091,7,123,114,9,401,366,7,21,7,41
"2011","South Derbyshire 002","E02004119","Total",4330,3465,1245,2220,18,283,183,100,544,499,5,36,4,20
"2011","South Derbyshire 003","E02004120","Total",2903,2414,1115,1299,4,125,93,32,329,300,2,25,2,31
"2011","South Derbyshire 004","E02004121","Total",2800,2411,1191,1220,11,127,101,26,227,193,4,25,5,24
"2011","South Derbyshire 005","E02004122","Total",2472,2011,1107,904,11,83,67,16,288,209,50,24,5,79
"2011","South Derbyshire 006","E02004123","Total",2816,1991,1081,910,4,300,236,64,479,443,5,23,8,42
"2011","South Derbyshire 007","E02004124","Total",3141,2262,1159,1103,1,596,532,64,255,226,1,27,1,27
"2011","South Derbyshire 008","E02004125","Total",3775,2656,1204,1452,8,551,425,126,521,483,3,32,3,39
"2011","South Derbyshire 009","E02004126","Total",3009,2129,976,1153,9,441,364,77,366,339,6,20,1,64
"2011","South Derbyshire 011","E02004128","Total",4296,3329,1645,1684,12,429,374,55,462,411,4,42,5,64
"2011","South Derbyshire 012","E02006919","Total",3595,2452,787,1665,25,346,186,160,745,687,2,51,5,27
"2011","South Derbyshire 013","E02006920","Total",3155,2168,690,1478,21,473,309,164,470,447,2,18,3,23
"2011","Blaby 002","E02005334","Total",2161,1957,860,1097,6,19,4,15,171,153,1,14,3,8
"2011","Blaby 003","E02005335","Total",2824,2372,1289,1083,3,160,45,115,259,236,2,19,2,30
"2011","Blaby 004","E02005336","Total",2903,2115,645,1470,7,198,66,132,560,525,6,26,3,23
"2011","Blaby 005","E02005337","Total",3961,3196,1692,1504,28,212,31,181,489,445,6,37,1,36
"2011","Blaby 006","E02005338","Total",4167,3179,1428,1751,39,492,121,371,420,361,4,46,9,37
"2011","Blaby 007","E02005339","Total",3502,2926,1236,1690,12,185,37,148,364,339,0,21,4,15
"2011","Blaby 008","E02005340","Total",3553,2770,1363,1407,34,351,92,259,366,326,5,30,5,32
"2011","Blaby 009","E02005341","Total",2753,2158,783,1375,32,306,51,255,235,209,2,22,2,22
"2011","Blaby 010","E02005342","Total",2802,2247,1094,1153,17,285,87,198,231,195,4,26,6,22
"2011","Blaby 011","E02005343","Total",2797,2368,1221,1147,21,168,39,129,217,179,0,35,3,23
"2011","Blaby 012","E02005344","Total",3146,2508,1207,1301,29,340,85,255,245,214,5,24,2,24
"2011","Blaby 013","E02006820","Total",4117,3513,1927,1586,19,232,63,169,319,289,3,25,2,34
"2011","Charnwood 001","E02005345","Total",2600,1963,958,1005,32,271,59,212,314,284,3,21,6,20
"2011","Charnwood 002","E02005346","Total",4925,2083,851,1232,71,1441,744,697,1250,1172,6,54,18,80
"2011","Charnwood 003","E02005347","Total",3449,1257,691,566,31,704,479,225,1404,1337,8,51,8,53
"2011","Charnwood 004","E02005348","Total",2540,1837,945,892,10,309,181,128,368,338,2,23,5,16
"2011","Charnwood 005","E02005349","Total",2980,2315,1123,1192,18,313,248,65,299,277,3,14,5,35
"2011","Charnwood 006","E02005350","Total",2813,2098,917,1181,34,322,220,102,335,300,2,30,3,24
"2011","Charnwood 007","E02005351","Total",2328,1285,712,573,12,522,414,108,469,431,3,26,9,40
"2011","Charnwood 008","E02005352","Total",2421,2041,1060,981,9,105,83,22,226,197,5,19,5,40
"2011","Charnwood 009","E02005353","Total",3824,2232,1014,1218,20,884,712,172,642,593,3,40,6,46
"2011","Charnwood 010","E02005354","Total",3542,3186,1785,1401,22,48,12,36,265,241,4,18,2,21
"2011","Charnwood 011","E02005355","Total",2766,2163,1040,1123,33,233,181,52,308,273,6,24,5,29
"2011","Charnwood 012","E02005356","Total",2873,2227,1141,1086,23,212,151,61,381,347,3,27,4,30
"2011","Charnwood 013","E02005357","Total",3036,2325,971,1354,8,282,249,33,395,362,6,23,4,26
"2011","Charnwood 014","E02005358","Total",4281,3295,1426,1869,33,486,387,99,420,375,3,37,5,47
"2011","Charnwood 015","E02005359","Total",2390,2053,1073,980,13,81,75,6,211,195,1,14,1,32
"2011","Charnwood 016","E02005360","Total",2546,2108,1264,844,10,117,108,9,254,204,23,12,15,57
"2011","Charnwood 017","E02005361","Total",2778,1985,838,1147,29,251,163,88,486,438,5,40,3,27
"2011","Charnwood 018","E02005362","Total",2627,2078,1005,1073,18,286,202,84,217,187,4,26,0,28
"2011","Charnwood 019","E02005363","Total",2944,2536,1443,1093,23,134,57,77,225,200,3,21,1,26
"2011","Charnwood 020","E02005364","Total",2098,1756,828,928,7,125,89,36,191,172,3,13,3,19
"2011","Charnwood 021","E02005365","Total",3944,3003,1592,1411,71,383,204,179,450,410,4,34,2,37
"2011","Charnwood 022","E02005366","Total",2811,2135,1052,1083,12,342,288,54,286,257,2,23,4,36
"2011","Harborough 002","E02005368","Total",2581,1932,1062,870,17,194,25,169,372,325,18,24,5,66
"2011","Harborough 003","E02005369","Total",4128,3227,1711,1516,24,374,47,327,459,418,4,29,8,44
"2011","Harborough 004","E02005370","Total",3422,2906,1075,1831,29,174,33,141,293,261,3,24,5,20
"2011","Harborough 005","E02005371","Total",3970,3235,1497,1738,39,246,49,197,408,365,9,32,2,42
"2011","Harborough 006","E02005372","Total",3749,3131,1594,1537,13,222,58,164,331,293,3,26,9,52
"2011","Harborough 007","E02005373","Total",3773,3245,1705,1540,15,129,29,100,345,301,7,33,4,39
"2011","Harborough 008","E02005374","Total",3008,1655,810,845,78,752,111,641,485,442,7,32,4,38
"2011","Harborough 009","E02005375","Total",3518,2636,1200,1436,74,168,19,149,612,578,3,27,4,28
"2011","Harborough 010","E02005376","Total",3940,2881,1415,1466,65,538,93,445,408,371,2,29,6,48
"2011","Harborough 011","E02006816","Total",2809,2390,1320,1070,60,126,17,109,209,186,1,18,4,24
"2011","Hinckley and Bosworth 001","E02005377","Total",3568,2891,1463,1428,21,322,254,68,305,271,3,26,5,29
"2011","Hinckley and Bosworth 002","E02005378","Total",2183,1876,885,991,3,111,70,41,179,172,1,6,0,14
"2011","Hinckley and Bosworth 003","E02005379","Total",2532,2055,1028,1027,15,223,159,64,222,197,4,19,2,17
"2011","Hinckley and Bosworth 004","E02005380","Total",3562,2733,1422,1311,16,367,260,107,394,317,26,28,23,52
"2011","Hinckley and Bosworth 005","E02005381","Total",3378,2734,1499,1235,11,365,299,66,224,190,2,22,10,44
"2011","Hinckley and Bosworth 006","E02005382","Total",4390,3029,1363,1666,48,720,470,250,555,508,5,35,7,38
"2011","Hinckley and Bosworth 007","E02005383","Total",3908,2826,1216,1610,30,559,363,196,452,425,0,27,0,41
"2011","Hinckley and Bosworth 008","E02005384","Total",2646,2187,1091,1096,7,147,101,46,265,233,3,25,4,40
"2011","Hinckley and Bosworth 009","E02005385","Total",2525,2252,1185,1067,9,34,11,23,215,199,2,13,1,15
"2011","Hinckley and Bosworth 010","E02005386","Total",3870,2466,1077,1389,26,372,250,122,969,903,8,53,5,37
"2011","Hinckley and Bosworth 011","E02005387","Total",3858,2894,1127,1767,50,365,207,158,531,485,3,37,6,18
"2011","Hinckley and Bosworth 012","E02005388","Total",2564,1767,813,954,16,403,243,160,346,311,4,28,3,32
"2011","Hinckley and Bosworth 013","E02005389","Total",2619,1812,1018,794,5,591,510,81,172,153,2,15,2,39
"2011","Hinckley and Bosworth 014","E02005390","Total",3774,3304,1672,1632,10,106,41,65,327,293,2,30,2,27
"2011","Melton 001","E02005391","Total",4087,3034,1599,1435,37,320,272,48,599,539,13,36,11,97
"2011","Melton 002","E02005392","Total",3815,3163,1568,1595,34,145,70,75,449,408,6,31,4,24
"2011","Melton 003","E02005393","Total",3001,2280,1101,1179,23,294,252,42,354,307,15,17,15,50
"2011","Melton 004","E02005394","Total",3961,2351,1108,1243,88,919,604,315,568,504,15,34,15,35
"2011","Melton 005","E02005395","Total",3837,2723,1312,1411,6,550,502,48,516,466,4,41,5,42
"2011","Melton 006","E02005396","Total",2789,1947,1040,907,10,174,114,60,568,514,23,24,7,90
"2011","North West Leicestershire 001","E02005397","Total",3576,2585,1233,1352,13,369,325,44,568,519,8,32,9,41
"2011","North West Leicestershire 002","E02005398","Total",2598,1862,969,893,19,243,205,38,431,385,3,38,5,43
"2011","North West Leicestershire 003","E02005399","Total",2752,1875,907,968,34,385,143,242,431,392,3,33,3,27
"2011","North West Leicestershire 004","E02005400","Total",2438,1879,1041,838,25,302,260,42,209,194,3,11,1,23
"2011","North West Leicestershire 005","E02005401","Total",2345,1883,972,911,9,229,199,30,185,165,3,15,2,39
"2011","North West Leicestershire 006","E02005402","Total",2498,1841,984,857,42,407,356,51,180,166,0,12,2,28
"2011","North West Leicestershire 007","E02005403","Total",2966,2344,1151,1193,26,310,263,47,247,223,1,22,1,39
"2011","North West Leicestershire 008","E02005404","Total",3145,2295,1078,1217,7,551,476,75,258,242,1,15,0,34
"2011","North West Leicestershire 009","E02005405","Total",2828,1574,828,746,7,1078,750,328,127,110,0,13,4,42
"2011","North West Leicestershire 010","E02005406","Total",3125,1982,789,1193,35,463,191,272,604,562,5,32,5,41
"2011","North West Leicestershire 011","E02005407","Total",3481,2828,1079,1749,55,184,85,99,383,339,1,42,1,31
"2011","North West Leicestershire 012","E02005408","Total",3074,2162,1091,1071,11,496,421,75,367,330,4,30,3,38
"2011","North West Leicestershire 013","E02005409","Total",4302,3250,1459,1791,19,581,507,74,421,370,3,41,7,31
"2011","Oadby and Wigston 003","E02005412","Total",3310,2605,1550,1055,16,291,228,63,344,308,4,28,4,54
"2011","Oadby and Wigston 005","E02005414","Total",3245,2142,1011,1131,33,728,607,121,293,263,3,19,8,49
"2011","Oadby and Wigston 006","E02005415","Total",3256,2301,1067,1234,39,371,183,188,518,467,4,41,6,27
"2011","Oadby and Wigston 007","E02005416","Total",3613,3248,1738,1510,29,66,28,38,247,230,0,16,1,23
"2011","Oadby and Wigston 008","E02006818","Total",3277,2923,1634,1289,20,61,51,10,247,218,5,24,0,26
"2011","Oadby and Wigston 009","E02006911","Total",4638,4020,2069,1951,24,93,50,43,468,436,1,25,6,33
"2011","Boston 001","E02005417","Total",2935,2217,1244,973,16,427,127,300,218,163,28,15,12,57
"2011","Boston 002","E02005418","Total",4119,1624,774,850,30,1471,603,868,926,873,5,35,13,68
"2011","Boston 003","E02005419","Total",3591,1689,900,789,51,439,132,307,1366,1305,9,32,20,46
"2011","Boston 004","E02005420","Total",3623,2106,1021,1085,51,956,291,665,451,414,1,32,4,59
"2011","Boston 006","E02005422","Total",2569,1900,1024,876,17,367,117,250,250,221,9,14,6,35
"2011","Boston 007","E02005423","Total",4106,2557,1334,1223,31,1034,327,707,436,378,19,30,9,48
"2011","Boston 008","E02006864","Total",3361,2796,1556,1240,24,174,51,123,333,284,12,29,8,34
"2011","Boston 009","E02006865","Total",2987,2541,1390,1151,10,97,23,74,311,270,2,33,6,28
"2011","East Lindsey 001","E02005424","Total",4281,3530,1940,1590,12,237,56,181,439,374,18,38,9,63
"2011","East Lindsey 002","E02005425","Total",2688,2191,1247,944,9,175,36,139,277,235,10,25,7,36
"2011","East Lindsey 003","E02005426","Total",4151,2534,1323,1211,45,1040,281,759,481,437,1,43,0,51
"2011","East Lindsey 004","E02005427","Total",3379,2143,1171,972,12,257,53,204,927,874,2,42,9,40
"2011","East Lindsey 005","E02005428","Total",3686,2521,1691,830,26,531,85,446,556,511,5,35,5,52
"2011","East Lindsey 006","E02005429","Total",3244,2540,1961,579,18,169,17,152,476,446,6,21,3,41
"2011","East Lindsey 007","E02005430","Total",3059,2337,1503,834,20,193,38,155,441,390,17,26,8,68
"2011","East Lindsey 008","E02005431","Total",3643,2630,1664,966,15,384,94,290,544,467,21,50,6,70
"2011","East Lindsey 009","E02005432","Total",3303,2420,1528,892,11,163,40,123,591,515,32,28,16,118
"2011","East Lindsey 010","E02005433","Total",3259,2306,1717,589,38,283,74,209,571,515,11,40,5,61
"2011","East Lindsey 011","E02005434","Total",3291,2199,1285,914,16,428,94,334,600,553,4,40,3,48
"2011","East Lindsey 012","E02005435","Total",3292,2137,1354,783,61,303,81,222,773,727,9,34,3,18
"2011","East Lindsey 013","E02005436","Total",3454,2408,1472,936,32,392,107,285,563,500,7,52,4,59
"2011","East Lindsey 014","E02005437","Total",2695,1137,601,536,11,173,24,149,1348,1281,10,52,5,26
"2011","East Lindsey 015","E02005438","Total",3016,1648,975,673,40,934,251,683,355,325,5,21,4,39
"2011","East Lindsey 016","E02005439","Total",4599,3168,1869,1299,74,373,81,292,908,593,173,50,92,76
"2011","East Lindsey 017","E02005440","Total",2272,1468,857,611,21,390,116,274,330,269,23,33,5,63
"2011","East Lindsey 018","E02005441","Total",3578,2820,1668,1152,21,280,77,203,374,322,23,27,2,83
"2011","Lincoln 001","E02005442","Total",2710,1082,484,598,3,1366,1307,59,166,143,6,16,1,93
"2011","Lincoln 002","E02005443","Total",3177,1926,862,1064,12,673,567,106,526,484,1,39,2,40
"2011","Lincoln 003","E02005444","Total",5257,3157,1558,1599,43,472,391,81,1491,1387,6,74,24,94
"2011","Lincoln 004","E02005445","Total",4806,1892,721,1171,47,1713,1518,195,1072,990,6,67,9,82
"2011","Lincoln 005","E02005446","Total",2840,1012,463,549,15,472,379,93,1293,1242,4,40,7,48
"2011","Lincoln 006","E02005447","Total",3202,1194,470,724,9,523,360,163,1428,1340,8,71,9,48
"2011","Lincoln 007","E02005448","Total",3126,1566,549,1017,44,1094,924,170,363,324,4,32,3,59
"2011","Lincoln 008","E02005449","Total",2891,1931,901,1030,13,231,103,128,699,646,3,43,7,17
"2011","Lincoln 009","E02005450","Total",3708,3056,1388,1668,13,147,97,50,478,418,4,55,1,14
"2011","Lincoln 010","E02005451","Total",3421,1430,571,859,13,1454,1342,112,463,416,4,43,0,61
"2011","Lincoln 011","E02005452","Total",4687,3686,1750,1936,8,584,393,191,366,319,2,44,1,43
"2011","North Kesteven 001","E02005453","Total",4569,4011,2105,1906,5,50,38,12,457,391,11,47,8,46
"2011","North Kesteven 003","E02005455","Total",5113,4050,1814,2236,18,276,253,23,695,630,13,47,5,74
"2011","North Kesteven 004","E02005456","Total",4023,2637,1327,1310,22,570,399,171,738,380,222,36,100,56
"2011","North Kesteven 005","E02005457","Total",3565,2643,1318,1325,16,495,419,76,350,313,7,23,7,61
"2011","North Kesteven 006","E02005458","Total",2764,2105,1112,993,5,273,249,24,314,270,10,27,7,67
"2011","North Kesteven 007","E02005459","Total",3420,2230,1143,1087,7,714,688,26,375,319,17,35,4,94
"2011","North Kesteven 008","E02005460","Total",2387,1547,703,844,4,131,97,34,673,254,289,19,111,32
"2011","North Kesteven 009","E02005461","Total",2817,2119,1238,881,8,245,219,26,394,341,13,25,15,51
"2011","North Kesteven 010","E02005462","Total",4123,2438,1090,1348,16,843,612,231,747,699,5,41,2,79
"2011","North Kesteven 011","E02005463","Total",3530,2807,1208,1599,38,195,56,139,464,433,6,22,3,26
"2011","North Kesteven 012","E02005464","Total",3591,2738,1463,1275,14,418,359,59,366,333,5,22,6,55
"2011","North Kesteven 013","E02006866","Total",2792,2063,1018,1045,59,343,200,143,309,274,3,26,6,18
"2011","North Kesteven 014","E02006867","Total",3278,2799,1576,1223,9,141,104,37,302,269,1,30,2,27
"2011","South Holland 001","E02005465","Total",3523,2782,1552,1230,12,407,371,36,283,245,19,18,1,39
"2011","South Holland 002","E02005466","Total",2699,2165,1261,904,6,276,234,42,219,169,19,13,18,33
"2011","South Holland 003","E02005467","Total",3209,2237,1257,980,25,429,325,104,458,418,3,33,4,60
"2011","South Holland 004","E02005468","Total",3084,2406,1348,1058,12,371,331,40,242,210,10,17,5,53
"2011","South Holland 005","E02005469","Total",3079,2289,1169,1120,11,421,367,54,306,232,48,22,4,52
"2011","South Holland 006","E02005470","Total",4483,2992,1558,1434,64,423,255,168,954,887,13,45,9,50
"2011","South Holland 007","E02005471","Total",3857,2244,1250,994,19,913,778,135,609,555,7,41,6,72
"2011","South Holland 008","E02005472","Total",4314,2919,1673,1246,22,691,523,168,606,546,18,31,11,76
"2011","South Holland 009","E02005473","Total",3767,2805,1369,1436,81,272,173,99,575,512,6,50,7,34
"2011","South Holland 010","E02005474","Total",2726,2244,1261,983,7,224,210,14,218,184,10,18,6,33
"2011","South Holland 011","E02005475","Total",2523,1952,925,1027,1,301,261,40,244,215,6,20,3,25
"2011","South Kesteven 001","E02005476","Total",3017,2339,1120,1219,12,299,255,44,315,270,12,27,6,52
"2011","South Kesteven 002","E02005477","Total",3798,2981,1731,1250,36,409,316,93,309,263,7,31,8,63
"2011","South Kesteven 003","E02005478","Total",4339,2716,1434,1282,18,1036,907,129,494,442,3,43,6,75
"2011","South Kesteven 004","E02005479","Total",3558,2651,1215,1436,12,287,186,101,571,539,4,21,7,37
"2011","South Kesteven 005","E02005480","Total",2861,1372,542,830,19,1096,985,111,338,307,4,25,2,36
"2011","South Kesteven 006","E02005481","Total",4985,2672,1148,1524,63,596,338,258,1603,1517,9,72,5,51
"2011","South Kesteven 007","E02005482","Total",4092,3066,1350,1716,31,225,158,67,650,573,32,25,20,120
"2011","South Kesteven 008","E02005483","Total",3224,2418,1158,1260,11,379,337,42,366,315,10,24,17,50
"2011","South Kesteven 009","E02005484","Total",3030,1883,916,967,21,483,306,177,539,493,8,28,10,104
"2011","South Kesteven 010","E02005485","Total",2531,2067,1080,987,24,159,126,33,239,210,4,22,3,42
"2011","South Kesteven 011","E02005486","Total",3580,2358,1076,1282,113,520,352,168,545,495,14,33,3,44
"2011","South Kesteven 012","E02005487","Total",3664,3027,1479,1548,15,245,210,35,309,275,11,19,4,68
"2011","South Kesteven 013","E02005488","Total",2686,2033,1043,990,5,359,171,188,255,223,3,25,4,34
"2011","South Kesteven 014","E02005489","Total",2985,2345,974,1371,43,209,132,77,359,326,0,31,2,29
"2011","South Kesteven 015","E02005490","Total",4046,2537,1194,1343,61,883,772,111,509,473,0,32,4,56
"2011","South Kesteven 016","E02005491","Total",4948,3344,1798,1546,18,516,398,118,988,932,12,38,6,82
"2011","West Lindsey 001","E02005492","Total",4067,2965,1631,1334,19,442,67,375,527,461,22,37,7,114
"2011","West Lindsey 002","E02005493","Total",3881,3140,1549,1591,43,314,80,234,341,302,9,22,8,43
"2011","West Lindsey 003","E02005494","Total",4130,2906,1604,1302,25,414,63,351,702,641,13,43,5,83
"2011","West Lindsey 004","E02005495","Total",4499,2643,1238,1405,29,535,102,433,1240,1150,17,68,5,52
"2011","West Lindsey 005","E02005496","Total",2685,1881,933,948,24,155,27,128,547,486,35,19,7,78
"2011","West Lindsey 006","E02005497","Total",2981,1349,576,773,58,1315,399,916,221,200,3,16,2,38
"2011","West Lindsey 007","E02005498","Total",3152,2619,1541,1078,14,202,43,159,267,221,11,27,8,50
"2011","West Lindsey 008","E02005499","Total",3317,2686,1413,1273,53,223,39,184,311,262,9,36,4,44
"2011","West Lindsey 009","E02005500","Total",2867,2094,1011,1083,47,168,18,150,510,369,79,22,40,48
"2011","West Lindsey 010","E02005501","Total",3112,2628,1537,1091,26,148,21,127,261,230,4,17,10,49
"2011","West Lindsey 011","E02005502","Total",3694,2948,1639,1309,27,330,52,278,326,272,14,29,11,63
"2011","Corby 001","E02005612","Total",2744,1806,783,1023,22,500,360,140,367,334,5,19,9,49
"2011","Corby 002","E02005613","Total",3712,2342,897,1445,8,838,813,25,471,441,4,26,0,53
"2011","Corby 003","E02005614","Total",2907,1862,755,1107,16,536,440,96,450,424,1,24,1,43
"2011","Corby 004","E02005615","Total",3699,2500,1191,1309,9,759,733,26,382,334,1,42,5,49
"2011","Corby 005","E02005616","Total",2221,1192,504,688,5,654,516,138,337,316,1,20,0,33
"2011","Corby 006","E02005617","Total",4051,2015,842,1173,8,1318,1230,88,656,622,0,28,6,54
"2011","Corby 008","E02006862","Total",2499,1788,639,1149,11,392,353,39,274,247,2,24,1,34
"2011","Corby 009","E02006863","Total",3382,2164,306,1858,15,281,18,263,902,864,3,27,8,20
"2011","Daventry 001","E02005619","Total",2348,1802,935,867,7,203,55,148,278,252,12,10,4,58
"2011","Daventry 002","E02005620","Total",3094,2442,1042,1400,8,250,69,181,323,286,9,20,8,71
"2011","Daventry 003","E02005621","Total",2883,2257,1179,1078,17,357,96,261,220,190,6,18,6,32
"2011","Daventry 004","E02005622","Total",3551,2795,1407,1388,30,199,60,139,468,421,15,26,6,59
"2011","Daventry 005","E02005623","Total",3316,2606,1392,1214,28,322,127,195,309,269,6,27,7,51
"2011","Daventry 006","E02005624","Total",3702,2537,851,1686,109,521,89,432,512,488,0,24,0,23
"2011","Daventry 007","E02005625","Total",3909,2341,1074,1267,26,899,236,663,599,552,5,32,10,44
"2011","Daventry 008","E02005626","Total",2734,1467,502,965,26,776,297,479,438,390,3,42,3,27
"2011","Daventry 009","E02005627","Total",2955,2037,1009,1028,10,531,145,386,335,308,1,21,5,42
"2011","Daventry 010","E02005628","Total",3155,2404,1142,1262,10,354,108,246,350,315,6,23,6,37
"2011","East Northamptonshire 001","E02005629","Total",2398,1652,911,741,25,349,68,281,317,284,10,18,5,55
"2011","East Northamptonshire 002","E02005630","Total",3798,2634,1454,1180,28,444,68,376,604,512,58,26,8,88
"2011","East Northamptonshire 003","E02005631","Total",4064,2928,1195,1733,10,462,67,395,607,564,3,33,7,57
"2011","East Northamptonshire 004","E02005632","Total",2464,1908,903,1005,17,312,54,258,196,169,2,21,4,31
"2011","East Northamptonshire 005","E02005633","Total",3555,2676,1168,1508,8,454,94,360,389,352,5,30,2,28
"2011","East Northamptonshire 006","E02005634","Total",3568,2409,882,1527,14,659,84,575,448,415,5,28,0,38
"2011","East Northamptonshire 007","E02005635","Total",3511,2642,1028,1614,6,410,71,339,417,379,5,30,3,36
"2011","East Northamptonshire 008","E02005636","Total",4554,3278,1417,1861,19,777,145,632,439,382,2,51,4,41
"2011","East Northamptonshire 009","E02005637","Total",3869,2259,957,1302,32,817,148,669,717,665,4,45,3,44
"2011","East Northamptonshire 010","E02005638","Total",3881,3451,1504,1947,16,53,6,47,337,310,2,22,3,24
"2011","Kettering 001","E02005639","Total",2246,1652,894,758,4,196,163,33,321,297,7,17,0,73
"2011","Kettering 002","E02005640","Total",4390,3343,1396,1947,69,425,267,158,502,457,4,38,3,51
"2011","Kettering 003","E02005641","Total",3366,2346,1106,1240,9,478,308,170,489,448,8,32,1,44
"2011","Kettering 004","E02005642","Total",3277,2700,1101,1599,15,115,45,70,417,373,4,32,8,30
"2011","Kettering 005","E02005643","Total",3420,1620,592,1028,14,1298,1100,198,424,376,3,44,1,64
"2011","Kettering 006","E02005644","Total",3645,1952,673,1279,36,247,95,152,1376,1288,2,83,3,34
"2011","Kettering 007","E02005645","Total",5081,2881,1310,1571,67,932,532,400,1094,1017,16,52,9,107
"2011","Kettering 008","E02005646","Total",2700,2363,1234,1129,13,43,6,37,258,229,0,22,7,23
"2011","Kettering 009","E02005647","Total",3145,2002,875,1127,25,717,480,237,361,327,3,27,4,40
"2011","Kettering 010","E02005648","Total",2897,2573,1262,1311,9,75,57,18,218,196,4,14,4,22
"2011","Kettering 011","E02005649","Total",5534,4130,1627,2503,81,661,453,208,588,525,2,57,4,74
"2011","Northampton 001","E02005650","Total",2373,1883,915,968,2,189,178,11,278,246,1,27,4,21
"2011","Northampton 002","E02005651","Total",2744,2454,1308,1146,18,38,9,29,214,175,5,33,1,20
"2011","Northampton 003","E02005652","Total",2609,2057,1066,991,9,280,198,82,219,188,2,27,2,44
"2011","Northampton 004","E02005653","Total",3162,1746,511,1235,24,848,711,137,500,458,1,34,7,44
"2011","Northampton 005","E02005654","Total",3228,1813,516,1297,118,883,750,133,396,353,0,41,2,18
"2011","Northampton 006","E02005655","Total",2560,2068,1090,978,21,231,209,22,211,191,1,18,1,29
"2011","Northampton 007","E02005656","Total",2286,1089,384,705,8,869,767,102,295,260,2,24,9,25
"2011","Northampton 008","E02005657","Total",2784,2118,1082,1036,39,216,35,181,390,365,0,22,3,21
"2011","Northampton 009","E02005658","Total",2569,1154,378,776,8,835,773,62,525,488,1,31,5,47
"2011","Northampton 010","E02005659","Total",2247,1692,879,813,7,355,261,94,160,125,1,29,5,33
"2011","Northampton 011","E02005660","Total",2294,1268,421,847,26,706,647,59,250,228,1,20,1,44
"2011","Northampton 012","E02005661","Total",2534,1351,467,884,6,812,728,84,327,293,1,29,4,38
"2011","Northampton 013","E02005662","Total",2772,2007,876,1131,3,253,219,34,476,441,3,26,6,33
"2011","Northampton 014","E02005663","Total",2348,1954,827,1127,7,31,25,6,339,307,0,31,1,17
"2011","Northampton 015","E02005664","Total",2493,1397,541,856,32,365,229,136,671,629,6,33,3,28
"2011","Northampton 016","E02005665","Total",3003,2216,790,1426,31,323,202,121,406,370,2,33,1,27
"2011","Northampton 017","E02005666","Total",3330,1244,382,862,60,1540,1309,231,417,396,1,18,2,69
"2011","Northampton 018","E02005667","Total",2676,1752,834,918,18,584,453,131,287,259,0,26,2,35
"2011","Northampton 019","E02005668","Total",2598,2231,1170,1061,10,156,114,42,183,153,2,23,5,18
"2011","Northampton 020","E02005669","Total",2251,2039,1059,980,10,33,25,8,153,139,0,10,4,16
"2011","Northampton 021","E02005670","Total",4056,927,294,633,112,1685,1157,528,1246,1174,11,52,9,86
"2011","Northampton 022","E02005671","Total",3102,1806,655,1151,27,196,51,145,1047,992,3,47,5,26
"2011","Northampton 023","E02005672","Total",3292,1207,385,822,48,385,158,227,1622,1547,7,50,18,30
"2011","Northampton 024","E02005673","Total",3249,1864,801,1063,38,442,343,99,855,802,1,48,4,50
"2011","Northampton 025","E02005674","Total",3341,1304,596,708,79,757,411,346,1146,1090,7,40,9,55
"2011","Northampton 026","E02005675","Total",2340,1304,337,967,36,663,564,99,308,278,2,24,4,29
"2011","Northampton 027","E02005676","Total",2389,1480,506,974,26,562,455,107,280,255,0,23,2,41
"2011","Northampton 028","E02005677","Total",3601,2115,820,1295,48,353,168,185,1043,976,8,49,10,42
"2011","Northampton 029","E02005678","Total",3986,2833,909,1924,251,303,30,273,575,540,1,31,3,24
"2011","Northampton 030","E02005679","Total",3565,2752,827,1925,7,89,73,16,697,654,2,38,3,20
"2011","Northampton 031","E02005680","Total",2949,2497,681,1816,5,131,67,64,301,285,0,14,2,15
"2011","South Northamptonshire 001","E02005681","Total",3286,2604,1393,1211,15,368,110,258,250,213,5,22,10,49
"2011","South Northamptonshire 002","E02005682","Total",2673,1994,1032,962,13,279,80,199,341,322,5,6,8,46
"2011","South Northamptonshire 003","E02005683","Total",5212,4025,1590,2435,58,477,128,349,593,538,11,39,5,59
"2011","South Northamptonshire 004","E02005684","Total",3311,2626,1243,1383,19,254,78,176,367,329,8,26,4,45
"2011","South Northamptonshire 005","E02005685","Total",3408,2289,982,1307,129,546,148,398,409,376,6,24,3,35
"2011","South Northamptonshire 006","E02005686","Total",3037,2389,1214,1175,3,276,65,211,299,254,12,26,7,70
"2011","South Northamptonshire 007","E02005687","Total",2356,1810,855,955,8,225,65,160,267,234,10,17,6,46
"2011","South Northamptonshire 008","E02005688","Total",3453,2739,1205,1534,58,289,72,217,329,299,2,21,7,38
"2011","South Northamptonshire 009","E02005689","Total",2951,2552,912,1640,13,59,5,54,310,282,1,25,2,17
"2011","South Northamptonshire 010","E02005690","Total",2363,1548,619,929,23,402,62,340,360,318,9,27,6,30
"2011","South Northamptonshire 011","E02005691","Total",2667,1909,984,925,18,330,88,242,315,274,15,13,13,95
"2011","Wellingborough 001","E02005692","Total",2981,2067,1031,1036,35,509,144,365,318,284,4,24,6,52
"2011","Wellingborough 002","E02005693","Total",3276,2077,913,1164,22,752,287,465,382,352,1,25,4,43
"2011","Wellingborough 003","E02005694","Total",3059,2694,1098,1596,10,59,5,54,280,249,1,23,7,16
"2011","Wellingborough 004","E02005695","Total",3248,1637,716,921,70,386,47,339,1109,1037,9,58,5,46
"2011","Wellingborough 005","E02005696","Total",2458,1228,472,756,51,916,242,674,231,205,1,20,5,32
"2011","Wellingborough 006","E02005697","Total",2964,1410,659,751,40,832,259,573,632,585,7,32,8,50
"2011","Wellingborough 007","E02005698","Total",2368,1565,724,841,17,539,225,314,213,185,2,20,6,34
"2011","Wellingborough 008","E02005699","Total",3164,1920,612,1308,27,896,293,603,289,262,2,21,4,32
"2011","Wellingborough 009","E02005700","Total",3860,3067,1631,1436,15,343,99,244,396,357,4,31,4,39
"2011","Wellingborough 010","E02005701","Total",4679,3621,1728,1893,28,444,119,325,510,449,6,46,9,76
"2011","Ashfield 001","E02005819","Total",2668,1871,1054,817,7,391,300,91,370,338,5,25,2,29
"2011","Ashfield 002","E02005820","Total",2513,2032,1075,957,9,151,130,21,280,256,1,23,0,41
"2011","Ashfield 003","E02005821","Total",2795,1636,712,924,2,770,623,147,353,320,0,29,4,34
"2011","Ashfield 004","E02005822","Total",3974,2312,923,1389,33,613,373,240,955,895,4,47,9,61
"2011","Ashfield 005","E02005823","Total",3214,1395,655,740,18,1312,1161,151,422,379,7,31,5,67
"2011","Ashfield 006","E02005824","Total",4097,3156,1529,1627,52,359,242,117,486,438,3,41,4,44
"2011","Ashfield 007","E02005825","Total",3241,2336,1212,1124,4,530,396,134,343,313,2,25,3,28
"2011","Ashfield 008","E02005826","Total",2602,1318,531,787,10,861,693,168,371,335,0,30,6,42
"2011","Ashfield 009","E02005827","Total",3453,2769,1282,1487,11,281,202,79,358,324,0,30,4,34
"2011","Ashfield 010","E02005828","Total",3116,2434,1302,1132,17,318,262,56,317,285,2,25,5,30
"2011","Ashfield 011","E02005829","Total",2785,2124,1072,1052,4,394,350,44,220,195,1,23,1,43
"2011","Ashfield 012","E02005830","Total",2642,2099,1120,979,10,209,147,62,291,252,1,35,3,33
"2011","Ashfield 013","E02005831","Total",3686,2789,1221,1568,27,491,329,162,341,322,0,16,3,38
"2011","Ashfield 014","E02005832","Total",4034,2425,989,1436,21,606,437,169,922,841,2,71,8,60
"2011","Ashfield 015","E02005833","Total",3041,2666,1325,1341,5,120,77,43,225,194,1,28,2,25
"2011","Ashfield 016","E02005834","Total",3070,1899,950,949,5,852,738,114,250,221,2,22,5,64
"2011","Bassetlaw 001","E02005835","Total",4289,2993,1476,1517,10,716,587,129,504,442,5,52,5,66
"2011","Bassetlaw 002","E02005836","Total",3809,3090,1653,1437,17,363,248,115,282,234,4,37,7,57
"2011","Bassetlaw 003","E02005837","Total",2825,2190,1204,986,4,274,236,38,296,252,15,18,11,61
"2011","Bassetlaw 004","E02005838","Total",3495,2480,1316,1164,9,646,591,55,308,269,5,32,2,52
"2011","Bassetlaw 005","E02005839","Total",2793,1854,940,914,8,604,524,80,261,235,0,23,3,66
"2011","Bassetlaw 006","E02005840","Total",3501,2777,1007,1770,19,295,225,70,387,356,3,28,0,23
"2011","Bassetlaw 008","E02005842","Total",3756,2510,1271,1239,4,649,524,125,538,497,7,28,6,55
"2011","Bassetlaw 009","E02005843","Total",2662,1820,693,1127,10,405,315,90,398,374,1,23,0,29
"2011","Bassetlaw 010","E02005844","Total",3411,2124,1007,1117,8,645,458,187,595,536,8,42,9,39
"2011","Bassetlaw 012","E02005846","Total",2835,1137,447,690,18,940,712,228,688,636,9,29,14,52
"2011","Bassetlaw 013","E02005847","Total",2921,2052,1069,983,28,255,184,71,541,504,2,26,9,45
"2011","Bassetlaw 014","E02005848","Total",2751,1916,998,918,5,281,205,76,396,349,18,15,14,153
"2011","Bassetlaw 015","E02005849","Total",3662,2822,1523,1299,22,378,293,85,388,332,28,19,9,52
"2011","Bassetlaw 016","E02006903","Total",4957,3350,1691,1659,10,1128,1050,78,393,346,6,39,2,76
"2011","Broxtowe 001","E02005850","Total",2942,2454,1346,1108,10,161,109,52,286,253,7,24,2,31
"2011","Broxtowe 002","E02005851","Total",2614,1462,688,774,13,751,593,158,321,281,0,36,4,67
"2011","Broxtowe 003","E02005852","Total",3426,2953,1616,1337,10,151,108,43,270,237,2,29,2,42
"2011","Broxtowe 004","E02005853","Total",3876,2902,1385,1517,14,547,432,115,368,331,5,27,5,45
"2011","Broxtowe 007","E02005856","Total",3104,2633,1630,1003,3,152,144,8,281,253,2,17,9,35
"2011","Broxtowe 008","E02005857","Total",2666,1782,831,951,12,467,428,39,368,327,2,37,2,37
"2011","Broxtowe 009","E02005858","Total",3085,1936,969,967,15,454,327,127,642,606,4,28,4,38
"2011","Broxtowe 010","E02005859","Total",3853,2780,1301,1479,9,517,447,70,502,448,7,45,2,45
"2011","Broxtowe 011","E02005860","Total",3809,1853,959,894,20,621,461,160,1256,1188,3,51,14,59
"2011","Broxtowe 012","E02005861","Total",2453,1660,758,902,12,261,109,152,510,480,1,27,2,10
"2011","Broxtowe 013","E02005862","Total",3356,2179,1116,1063,15,694,674,20,417,242,100,25,50,51
"2011","Broxtowe 014","E02005863","Total",3132,2505,1381,1124,6,178,157,21,410,384,4,18,4,33
"2011","Broxtowe 015","E02005864","Total",3350,2797,1279,1518,25,76,55,21,424,391,4,22,7,28
"2011","Broxtowe 016","E02006906","Total",5154,4374,2092,2282,4,188,148,40,539,481,2,49,7,49
"2011","Gedling 001","E02005865","Total",3414,2966,1730,1236,5,150,51,99,232,203,3,22,4,61
"2011","Gedling 002","E02005866","Total",3873,2937,1588,1349,16,365,117,248,504,446,4,41,13,51
"2011","Gedling 004","E02005868","Total",2798,2141,1130,1011,18,347,140,207,257,224,0,28,5,35
"2011","Gedling 005","E02005869","Total",2446,1431,665,766,16,680,261,419,282,243,2,26,11,37
"2011","Gedling 006","E02005870","Total",2957,1809,810,999,30,523,237,286,558,514,4,31,9,37
"2011","Gedling 007","E02005871","Total",3153,2613,1407,1206,13,136,41,95,371,336,1,31,3,20
"2011","Gedling 008","E02005872","Total",2512,2117,1260,857,12,102,31,71,251,210,9,26,6,30
"2011","Gedling 009","E02005873","Total",4272,3685,2059,1626,5,24,11,13,529,490,3,34,2,29
"2011","Gedling 010","E02005874","Total",3708,2991,1473,1518,21,216,85,131,455,415,2,36,2,25
"2011","Gedling 011","E02005875","Total",2983,2306,1095,1211,20,369,129,240,254,220,3,30,1,34
"2011","Gedling 012","E02005876","Total",3700,2864,1346,1518,9,314,115,199,471,417,0,48,6,42
"2011","Gedling 013","E02005877","Total",3169,2448,1136,1312,8,204,89,115,490,456,1,32,1,19
"2011","Gedling 014","E02005878","Total",4393,2822,1349,1473,45,741,297,444,721,662,7,48,4,64
"2011","Gedling 015","E02005879","Total",3451,2072,688,1384,41,477,155,322,840,777,3,55,5,21
"2011","Gedling 016","E02006835","Total",2520,1936,867,1069,12,278,202,76,273,237,4,29,3,21
"2011","Mansfield 001","E02005880","Total",2527,1650,931,719,14,566,339,227,263,243,0,18,2,34
"2011","Mansfield 002","E02005881","Total",2408,1547,811,736,12,459,330,129,347,309,0,32,6,43
"2011","Mansfield 003","E02005882","Total",3355,2765,1427,1338,3,356,292,64,193,161,1,29,2,38
"2011","Mansfield 004","E02005883","Total",3347,1869,823,1046,26,957,790,167,446,406,1,37,2,49
"2011","Mansfield 005","E02005884","Total",2653,2051,965,1086,47,98,56,42,442,413,1,27,1,15
"2011","Mansfield 006","E02005885","Total",3577,2240,1178,1062,5,917,827,90,352,314,1,35,2,63
"2011","Mansfield 007","E02005886","Total",4231,3408,1618,1790,1,386,242,144,404,364,0,38,2,32
"2011","Mansfield 008","E02005887","Total",4048,1943,957,986,15,602,289,313,1434,1372,7,40,15,54
"2011","Mansfield 009","E02005888","Total",3726,1515,620,895,20,1366,1009,357,771,720,6,41,4,54
"2011","Mansfield 010","E02005889","Total",4406,3003,1461,1542,7,901,823,78,418,360,2,48,8,77
"2011","Mansfield 011","E02005890","Total",2790,2509,1229,1280,1,47,37,10,224,202,1,21,0,9
"2011","Mansfield 012","E02005891","Total",2839,1137,529,608,10,1474,1136,338,181,167,2,9,3,37
"2011","Mansfield 013","E02005892","Total",5021,4271,2109,2162,8,70,38,32,640,585,1,50,4,32
"2011","Newark and Sherwood 001","E02005893","Total",4277,2643,1343,1300,11,943,637,306,578,525,6,38,9,102
"2011","Newark and Sherwood 002","E02005894","Total",4095,2887,1332,1555,18,717,501,216,425,364,11,46,4,48
"2011","Newark and Sherwood 003","E02005895","Total",3356,2692,1548,1144,5,237,199,38,362,306,15,24,17,60
"2011","Newark and Sherwood 004","E02005896","Total",3156,2549,1449,1100,7,274,220,54,288,244,6,34,4,38
"2011","Newark and Sherwood 005","E02005897","Total",3652,2768,1501,1267,8,501,335,166,318,274,13,25,6,57
"2011","Newark and Sherwood 006","E02005898","Total",4555,3242,1424,1818,12,692,373,319,544,477,3,60,4,65
"2011","Newark and Sherwood 007","E02005899","Total",4955,2497,1073,1424,54,1086,611,475,1245,1172,11,52,10,73
"2011","Newark and Sherwood 008","E02005900","Total",3069,2280,1376,904,17,300,223,77,418,368,9,34,7,54
"2011","Newark and Sherwood 009","E02005901","Total",3827,2599,1221,1378,14,425,347,78,739,695,1,38,5,50
"2011","Newark and Sherwood 010","E02005902","Total",3602,2184,1128,1056,16,1048,935,113,283,240,2,37,4,71
"2011","Newark and Sherwood 011","E02005903","Total",4303,3320,1624,1696,24,432,377,55,472,428,2,38,4,55
"2011","Newark and Sherwood 012","E02005904","Total",3466,2692,1186,1506,50,240,191,49,443,416,3,21,3,41
"2011","Newark and Sherwood 013","E02005905","Total",2460,2102,1194,908,17,155,138,17,163,139,5,15,4,23
"2011","Rushcliffe 001","E02005906","Total",2615,2122,1136,986,11,187,46,141,260,233,8,16,3,35
"2011","Rushcliffe 002","E02005907","Total",3889,2969,1357,1612,40,444,119,325,414,381,3,18,12,22
"2011","Rushcliffe 003","E02005908","Total",3840,3128,1766,1362,19,303,76,227,356,315,3,33,5,34
"2011","Rushcliffe 004","E02005909","Total",3229,2525,1084,1441,10,120,33,87,556,514,1,37,4,18
"2011","Rushcliffe 005","E02005910","Total",3821,1984,828,1156,11,343,27,316,1455,1386,3,53,13,28
"2011","Rushcliffe 006","E02005911","Total",3501,2721,1228,1493,70,160,25,135,527,504,1,19,3,23
"2011","Rushcliffe 007","E02005912","Total",3627,2840,1386,1454,12,249,54,195,494,456,2,35,1,32
"2011","Rushcliffe 008","E02005913","Total",2764,2082,1149,933,16,401,116,285,243,226,2,13,2,22
"2011","Rushcliffe 009","E02005914","Total",2928,2173,957,1216,27,454,171,283,253,213,1,33,6,21
"2011","Rushcliffe 010","E02005915","Total",2397,1963,1051,912,18,154,48,106,237,213,1,15,8,25
"2011","Rushcliffe 011","E02005916","Total",3146,2320,1124,1196,48,361,128,233,389,360,2,26,1,28
"2011","Rushcliffe 012","E02005917","Total",2378,2177,1369,808,8,34,11,23,137,123,0,8,6,22
"2011","Rushcliffe 013","E02005918","Total",2260,1776,1054,722,26,236,81,155,196,177,5,14,0,26
"2011","Rushcliffe 014","E02005919","Total",2425,1781,1006,775,7,284,94,190,302,257,12,18,15,51
"2011","Rushcliffe 015","E02005920","Total",3015,2581,1478,1103,10,124,27,97,263,237,1,19,6,37
"2011","Herefordshire 001","E02002905","Total",2650,1973,1277,696,21,152,4,148,425,366,21,25,13,79
"2011","Herefordshire 002","E02002906","Total",2497,1596,960,636,23,464,36,428,387,353,5,23,6,27
"2011","Herefordshire 003","E02002907","Total",2687,1589,923,666,31,490,30,460,536,503,0,23,10,41
"2011","Herefordshire 004","E02002908","Total",3635,2681,1814,867,31,305,24,281,510,448,23,31,8,108
"2011","Herefordshire 005","E02002909","Total",4444,3090,1893,1197,29,576,60,516,653,570,26,47,10,96
"2011","Herefordshire 006","E02002910","Total",3420,2313,1563,750,27,405,44,361,563,506,30,21,6,112
"2011","Herefordshire 007","E02002911","Total",3790,2577,1523,1054,51,435,70,365,641,505,74,29,33,86
"2011","Herefordshire 008","E02002912","Total",2763,2139,1182,957,37,221,41,180,328,286,14,25,3,38
"2011","Herefordshire 009","E02002913","Total",2399,1811,1169,642,13,274,42,232,254,214,12,19,9,47
"2011","Herefordshire 010","E02002914","Total",4010,2697,1377,1320,45,464,153,311,758,703,7,38,10,46
"2011","Herefordshire 011","E02002915","Total",2832,2180,1281,899,24,253,63,190,342,309,7,24,2,33
"2011","Herefordshire 012","E02002916","Total",4424,1980,973,1007,65,1070,270,800,1230,1129,25,54,22,79
"2011","Herefordshire 013","E02002917","Total",3032,2119,1088,1031,32,264,78,186,567,501,14,44,8,50
"2011","Herefordshire 014","E02002918","Total",2422,2063,1212,851,12,152,23,129,165,140,3,17,5,30
"2011","Herefordshire 015","E02002919","Total",3855,2114,948,1166,60,1066,411,655,562,379,91,36,56,53
"2011","Herefordshire 016","E02002920","Total",2741,2034,1019,1015,28,246,86,160,397,359,5,27,6,36
"2011","Herefordshire 017","E02002921","Total",3176,1331,573,758,31,1516,651,865,254,226,2,22,4,44
"2011","Herefordshire 018","E02002922","Total",2601,1912,1154,758,13,238,34,204,369,335,14,13,7,69
"2011","Herefordshire 019","E02002923","Total",4315,2880,1751,1129,82,589,58,531,708,660,8,31,9,56
"2011","Herefordshire 020","E02002924","Total",2573,1931,1330,601,20,198,52,146,355,312,6,33,4,69
"2011","Herefordshire 021","E02002925","Total",4433,3122,1750,1372,34,446,146,300,735,641,24,59,11,96
"2011","Herefordshire 022","E02002926","Total",4784,3183,1860,1323,49,763,232,531,724,662,6,49,7,65
"2011","Herefordshire 023","E02002927","Total",4836,3699,2247,1452,12,316,84,232,684,573,51,48,12,125
"2011","Shropshire 025","E02006008","Total",3316,2174,1117,1057,20,603,443,160,464,414,11,34,5,55
"2011","Shropshire 027","E02006009","Total",2717,1745,1062,683,9,362,290,72,567,251,201,21,94,34
"2011","Shropshire 029","E02006010","Total",4799,3133,1754,1379,35,769,529,240,773,696,15,52,10,89
"2011","Shropshire 031","E02006011","Total",2683,1945,1110,835,8,325,262,63,357,320,3,29,5,48
"2011","Shropshire 033","E02006012","Total",2818,1965,1052,913,8,331,218,113,464,419,7,32,6,50
"2011","Shropshire 034","E02006013","Total",3195,2215,1269,946,6,288,221,67,585,513,27,33,12,101
"2011","Shropshire 035","E02006014","Total",3832,2721,1658,1063,16,409,294,115,572,514,17,38,3,114
"2011","Shropshire 001","E02006015","Total",4282,2719,1403,1316,39,659,91,568,811,758,10,34,9,54
"2011","Shropshire 002","E02006016","Total",3019,2318,1336,982,13,249,38,211,372,325,26,14,7,67
"2011","Shropshire 004","E02006017","Total",3098,2182,1262,920,22,328,52,276,505,455,15,26,9,61
"2011","Shropshire 005","E02006018","Total",5144,3490,1822,1668,39,802,139,663,742,673,15,45,9,71
"2011","Shropshire 008","E02006019","Total",2626,1821,1019,802,17,361,51,310,399,348,4,44,3,28
"2011","Shropshire 009","E02006020","Total",2422,1679,850,829,16,284,48,236,400,265,74,13,48,43
"2011","Shropshire 010","E02006021","Total",3015,2432,1289,1143,19,227,32,195,287,248,10,26,3,50
"2011","Shropshire 013","E02006022","Total",2275,1517,799,718,16,248,16,232,459,309,97,10,43,35
"2011","Shropshire 003","E02006023","Total",3829,2754,1488,1266,8,628,504,124,338,295,11,30,2,101
"2011","Shropshire 006","E02006024","Total",4098,2723,1251,1472,28,850,609,241,454,416,1,31,6,43
"2011","Shropshire 007","E02006025","Total",4205,2616,1439,1177,19,592,341,251,916,849,6,51,10,62
"2011","Shropshire 011","E02006026","Total",2785,2126,1136,990,16,280,217,63,319,278,16,22,3,44
"2011","Shropshire 012","E02006027","Total",2188,1761,1055,706,15,154,105,49,231,204,6,18,3,27
"2011","Shropshire 014","E02006028","Total",3661,2658,1420,1238,24,359,72,287,548,486,22,31,9,72
"2011","Shropshire 015","E02006029","Total",3316,2004,926,1078,18,1016,396,620,233,202,7,19,5,45
"2011","Shropshire 016","E02006030","Total",2904,1988,825,1163,17,573,201,372,294,262,1,28,3,32
"2011","Shropshire 017","E02006031","Total",3471,2035,865,1170,39,602,169,433,763,707,4,45,7,32
"2011","Shropshire 018","E02006032","Total",3695,2238,1010,1228,48,1070,338,732,280,247,2,28,3,59
"2011","Shropshire 019","E02006033","Total",3889,2152,1184,968,31,371,25,346,1281,1207,15,39,20,54
"2011","Shropshire 020","E02006034","Total",3746,2765,1391,1374,17,318,48,270,608,541,18,31,18,38
"2011","Shropshire 021","E02006035","Total",2553,2094,1286,808,4,226,54,172,200,179,4,16,1,29
"2011","Shropshire 022","E02006036","Total",2969,2023,1031,992,8,314,45,269,585,527,2,50,6,39
"2011","Shropshire 023","E02006037","Total",3999,2982,1633,1349,9,513,142,371,447,388,26,27,6,48
"2011","Shropshire 024","E02006038","Total",3223,2543,1473,1070,11,264,62,202,361,324,5,27,5,44
"2011","Shropshire 026","E02006039","Total",3239,2415,1433,982,19,444,132,312,304,246,8,39,11,57
"2011","Shropshire 028","E02006040","Total",2981,2118,1284,834,6,225,59,166,535,493,15,21,6,97
"2011","Shropshire 030","E02006041","Total",2472,1673,1099,574,14,272,29,243,432,375,11,38,8,81
"2011","Shropshire 032","E02006042","Total",2647,2015,1414,601,25,270,17,253,282,254,5,19,4,55
"2011","Shropshire 036","E02006043","Total",2946,1817,1169,648,33,357,31,326,622,556,36,26,4,117
"2011","Shropshire 037","E02006044","Total",2750,2019,1464,555,20,195,21,174,429,390,12,24,3,87
"2011","Shropshire 038","E02006045","Total",5173,3349,2196,1153,87,922,84,838,753,679,6,58,10,62
"2011","Shropshire 039","E02006046","Total",3694,2764,1724,1040,31,388,33,355,449,400,6,34,9,62
"2011","Stoke-on-Trent 001","E02002951","Total",3204,2428,1099,1329,4,530,505,25,201,185,0,14,2,41
"2011","Stoke-on-Trent 002","E02002952","Total",2837,1728,701,1027,5,708,660,48,349,312,2,33,2,47
"2011","Stoke-on-Trent 003","E02002953","Total",3090,1721,837,884,10,1151,821,330,157,139,1,17,0,51
"2011","Stoke-on-Trent 004","E02002954","Total",3619,2159,1154,1005,15,1086,1036,50,307,274,1,29,3,52
"2011","Stoke-on-Trent 005","E02002955","Total",3012,1573,731,842,4,556,271,285,827,793,0,27,7,52
"2011","Stoke-on-Trent 006","E02002956","Total",3855,2342,1121,1221,11,935,864,71,506,466,1,35,4,61
"2011","Stoke-on-Trent 007","E02002957","Total",4274,3560,1899,1661,10,217,204,13,440,401,3,34,2,47
"2011","Stoke-on-Trent 008","E02002958","Total",3568,2258,1026,1232,3,831,764,67,406,373,3,28,2,70
"2011","Stoke-on-Trent 009","E02002959","Total",3665,1549,718,831,26,1018,571,447,995,946,1,37,11,77
"2011","Stoke-on-Trent 010","E02002960","Total",2459,1851,925,926,10,389,373,16,178,158,1,19,0,31
"2011","Stoke-on-Trent 011","E02002961","Total",2857,1438,728,710,7,628,369,259,698,658,1,27,12,86
"2011","Stoke-on-Trent 012","E02002962","Total",3004,1179,583,596,16,1572,1137,435,177,154,0,12,11,60
"2011","Stoke-on-Trent 013","E02002963","Total",3559,1853,800,1053,5,818,693,125,803,741,3,53,6,80
"2011","Stoke-on-Trent 014","E02002964","Total",3846,2635,1442,1193,2,843,658,185,311,270,1,33,7,55
"2011","Stoke-on-Trent 015","E02002965","Total",2719,1107,476,631,16,745,340,405,777,714,18,28,17,74
"2011","Stoke-on-Trent 016","E02002966","Total",3900,1456,698,758,58,986,506,480,1327,1206,3,43,75,73
"2011","Stoke-on-Trent 017","E02002967","Total",4212,1275,618,657,27,2506,1526,980,319,279,2,23,15,85
"2011","Stoke-on-Trent 018","E02002968","Total",3980,2482,1153,1329,29,509,306,203,919,835,20,57,7,41
"2011","Stoke-on-Trent 019","E02002969","Total",4125,2048,911,1137,21,789,495,294,1197,1134,5,42,16,70
"2011","Stoke-on-Trent 020","E02002970","Total",3861,2064,895,1169,3,897,686,211,840,773,1,58,8,57
"2011","Stoke-on-Trent 021","E02002971","Total",2262,1650,759,891,7,209,137,72,368,347,2,18,1,28
"2011","Stoke-on-Trent 022","E02002972","Total",2844,1473,659,814,7,984,824,160,304,266,1,32,5,76
"2011","Stoke-on-Trent 023","E02002973","Total",3496,1917,820,1097,9,967,542,425,559,525,0,29,5,44
"2011","Stoke-on-Trent 024","E02002974","Total",2415,1913,1126,787,25,330,235,95,120,101,1,16,2,27
"2011","Stoke-on-Trent 025","E02002975","Total",3136,2799,1113,1686,24,109,95,14,181,160,0,20,1,23
"2011","Stoke-on-Trent 026","E02002976","Total",2420,1691,877,814,1,550,541,9,142,122,2,18,0,36
"2011","Stoke-on-Trent 027","E02002977","Total",2814,1666,972,694,6,782,701,81,287,258,2,21,6,73
"2011","Stoke-on-Trent 028","E02002978","Total",2793,1287,650,637,19,1096,971,125,347,318,2,26,1,44
"2011","Stoke-on-Trent 029","E02002979","Total",2075,1314,663,651,15,281,141,140,419,397,1,17,4,46
"2011","Stoke-on-Trent 030","E02002980","Total",2692,2190,1291,899,4,282,263,19,172,151,2,19,0,44
"2011","Stoke-on-Trent 031","E02002981","Total",3238,1917,747,1170,8,1001,837,164,271,251,0,14,6,41
"2011","Stoke-on-Trent 032","E02002982","Total",3194,1311,546,765,4,1529,1504,25,279,254,1,21,3,71
"2011","Stoke-on-Trent 033","E02002983","Total",2269,1998,896,1102,2,128,123,5,125,99,0,26,0,16
"2011","Stoke-on-Trent 034","E02002984","Total",2281,2096,994,1102,6,37,13,24,132,116,3,12,1,10
"2011","Telford and Wrekin 001","E02002928","Total",2365,1728,840,888,14,297,111,186,304,277,0,21,6,22
"2011","Telford and Wrekin 002","E02002929","Total",2135,1713,979,734,8,138,47,91,228,190,24,12,2,48
"2011","Telford and Wrekin 003","E02002930","Total",2388,1630,885,745,12,297,86,211,414,385,2,22,5,35
"2011","Telford and Wrekin 004","E02002931","Total",2472,2053,872,1181,2,172,24,148,227,189,8,24,6,18
"2011","Telford and Wrekin 005","E02002932","Total",3417,1706,617,1089,15,1146,530,616,503,428,28,27,20,47
"2011","Telford and Wrekin 006","E02002933","Total",3382,2629,1186,1443,7,387,147,240,332,296,0,34,2,27
"2011","Telford and Wrekin 007","E02002934","Total",2365,1630,614,1016,11,373,133,240,326,292,5,25,4,25
"2011","Telford and Wrekin 008","E02002935","Total",2724,1958,996,962,7,377,171,206,353,327,0,22,4,29
"2011","Telford and Wrekin 009","E02002936","Total",3174,1710,567,1143,12,818,351,467,578,547,2,27,2,56
"2011","Telford and Wrekin 010","E02002937","Total",4095,3134,1454,1680,28,300,118,182,576,530,9,28,9,57
"2011","Telford and Wrekin 011","E02002938","Total",2631,1459,679,780,6,658,316,342,454,399,21,26,8,54
"2011","Telford and Wrekin 012","E02002939","Total",2893,1824,962,862,11,615,257,358,404,381,1,17,5,39
"2011","Telford and Wrekin 013","E02002940","Total",2693,1623,691,932,23,579,214,365,428,394,1,26,7,40
"2011","Telford and Wrekin 014","E02002941","Total",4063,2544,1046,1498,14,951,422,529,509,468,2,31,8,45
"2011","Telford and Wrekin 015","E02002942","Total",2267,1806,762,1044,4,124,14,110,319,224,50,12,33,14
"2011","Telford and Wrekin 016","E02002943","Total",3528,2453,712,1741,23,559,174,385,468,423,3,40,2,25
"2011","Telford and Wrekin 017","E02002944","Total",3189,1312,445,867,16,1321,619,702,497,449,2,31,15,43
"2011","Telford and Wrekin 018","E02002945","Total",3588,2081,705,1376,7,856,309,547,610,567,1,40,2,34
"2011","Telford and Wrekin 019","E02002946","Total",3407,2149,802,1347,30,697,269,428,490,449,0,40,1,41
"2011","Telford and Wrekin 020","E02002947","Total",2671,1513,568,945,8,573,258,315,555,517,1,34,3,22
"2011","Telford and Wrekin 021","E02002948","Total",2475,1093,427,666,7,701,279,422,653,632,2,16,3,21
"2011","Telford and Wrekin 022","E02002949","Total",2429,1396,652,744,19,663,323,340,315,281,2,30,2,36
"2011","Telford and Wrekin 023","E02002950","Total",2257,1273,645,628,8,504,237,267,436,410,0,17,9,36
"2011","Cannock Chase 001","E02006118","Total",3032,2668,1387,1281,11,55,39,16,271,242,5,21,3,27
"2011","Cannock Chase 002","E02006119","Total",3481,2111,877,1234,16,747,519,228,563,518,6,33,6,44
"2011","Cannock Chase 003","E02006120","Total",3698,2634,1219,1415,20,522,372,150,499,464,1,31,3,23
"2011","Cannock Chase 004","E02006121","Total",2293,1551,621,930,2,473,404,69,234,213,0,18,3,33
"2011","Cannock Chase 005","E02006122","Total",2839,1919,840,1079,12,387,347,40,485,442,3,37,3,36
"2011","Cannock Chase 006","E02006123","Total",2616,1951,710,1241,6,377,316,61,253,230,0,21,2,29
"2011","Cannock Chase 007","E02006124","Total",2992,1572,723,849,41,1036,790,246,282,249,3,25,5,61
"2011","Cannock Chase 008","E02006125","Total",3248,1927,894,1033,14,853,766,87,413,386,3,23,1,41
"2011","Cannock Chase 009","E02006126","Total",3372,2598,1057,1541,11,328,296,32,395,352,1,39,3,40
"2011","Cannock Chase 010","E02006127","Total",2797,2269,537,1732,30,134,12,122,353,326,2,25,0,11
"2011","Cannock Chase 011","E02006128","Total",3745,2816,1628,1188,8,459,237,222,408,371,6,29,2,54
"2011","Cannock Chase 012","E02006129","Total",3461,1795,813,982,68,1038,775,263,503,457,6,33,7,57
"2011","Cannock Chase 013","E02006130","Total",3090,2295,1082,1213,9,471,418,53,279,259,1,16,3,36
"2011","East Staffordshire 001","E02006131","Total",3152,2403,1350,1053,28,283,71,212,352,313,11,23,5,86
"2011","East Staffordshire 002","E02006132","Total",2535,1849,953,896,49,455,171,284,159,134,4,18,3,23
"2011","East Staffordshire 003","E02006133","Total",2942,2104,939,1165,13,326,121,205,471,421,14,33,3,28
"2011","East Staffordshire 004","E02006134","Total",3951,3185,1750,1435,13,378,109,269,313,279,12,18,4,62
"2011","East Staffordshire 005","E02006135","Total",3285,2879,1447,1432,4,113,28,85,263,245,3,14,1,26
"2011","East Staffordshire 006","E02006136","Total",3208,2625,1510,1115,8,194,47,147,319,257,9,30,23,62
"2011","East Staffordshire 007","E02006137","Total",3673,2260,1079,1181,40,793,286,507,539,494,13,30,2,41
"2011","East Staffordshire 008","E02006138","Total",2502,1404,602,802,10,459,166,293,605,550,0,48,7,24
"2011","East Staffordshire 009","E02006139","Total",2931,1472,746,726,32,487,124,363,896,838,9,41,8,44
"2011","East Staffordshire 010","E02006140","Total",3430,2220,1134,1086,13,811,261,550,352,318,1,30,3,34
"2011","East Staffordshire 011","E02006141","Total",4377,2109,952,1157,32,563,88,475,1612,1518,7,71,16,61
"2011","East Staffordshire 012","E02006142","Total",2211,2003,925,1078,5,26,5,21,160,140,1,19,0,17
"2011","East Staffordshire 013","E02006143","Total",3033,2360,1061,1299,5,188,64,124,459,421,3,31,4,21
"2011","East Staffordshire 014","E02006144","Total",3636,2005,984,1021,4,1174,411,763,406,371,3,31,1,47
"2011","East Staffordshire 015","E02006145","Total",2385,2001,1142,859,4,117,32,85,246,220,4,15,7,17
"2011","Lichfield 001","E02006146","Total",2896,2266,1112,1154,16,300,37,263,291,264,2,21,4,23
"2011","Lichfield 002","E02006147","Total",3000,2419,1135,1284,23,269,37,232,257,215,8,26,8,32
"2011","Lichfield 003","E02006148","Total",2945,2550,1332,1218,5,167,14,153,195,169,4,20,2,28
"2011","Lichfield 004","E02006149","Total",4590,2127,1023,1104,57,1692,204,1488,632,576,8,35,13,82
"2011","Lichfield 005","E02006150","Total",4902,4043,2186,1857,34,362,32,330,415,386,6,20,3,48
"2011","Lichfield 006","E02006151","Total",3693,2710,1290,1420,35,574,73,501,341,310,2,27,2,33
"2011","Lichfield 007","E02006152","Total",4268,3249,1548,1701,31,448,55,393,506,467,6,27,6,34
"2011","Lichfield 008","E02006153","Total",2767,2181,1158,1023,8,209,19,190,329,244,38,17,30,40
"2011","Lichfield 009","E02006154","Total",4115,3664,2077,1587,17,152,17,135,254,222,3,28,1,28
"2011","Lichfield 010","E02006155","Total",2315,1418,595,823,8,633,87,546,224,199,5,18,2,32
"2011","Lichfield 011","E02006156","Total",3046,2683,1549,1134,4,159,19,140,172,149,6,11,6,28
"2011","Lichfield 012","E02006157","Total",2687,1845,943,902,4,481,54,427,316,274,13,25,4,41
"2011","Newcastle-under-Lyme 001","E02006158","Total",3543,3200,1566,1634,5,97,26,71,217,182,1,29,5,24
"2011","Newcastle-under-Lyme 002","E02006159","Total",2480,1567,784,783,9,498,145,353,374,355,1,14,4,32
"2011","Newcastle-under-Lyme 003","E02006160","Total",3588,2292,1172,1120,9,952,328,624,289,258,0,23,8,46
"2011","Newcastle-under-Lyme 004","E02006161","Total",2783,2427,1075,1352,3,135,47,88,189,162,0,23,4,29
"2011","Newcastle-under-Lyme 005","E02006162","Total",3678,2758,1447,1311,16,558,205,353,304,268,3,27,6,42
"2011","Newcastle-under-Lyme 006","E02006163","Total",3226,2098,996,1102,5,866,391,475,214,185,0,25,4,43
"2011","Newcastle-under-Lyme 007","E02006164","Total",3179,1596,700,896,9,1122,454,668,400,372,1,15,12,52
"2011","Newcastle-under-Lyme 008","E02006165","Total",3448,2330,1031,1299,25,534,138,396,517,473,2,40,2,42
"2011","Newcastle-under-Lyme 009","E02006166","Total",3103,2634,1297,1337,6,105,15,90,336,300,0,33,3,22
"2011","Newcastle-under-Lyme 010","E02006167","Total",3942,1715,817,898,52,1739,688,1051,370,323,3,34,10,66
"2011","Newcastle-under-Lyme 011","E02006168","Total",4189,1835,943,892,14,1252,367,885,1018,952,5,46,15,70
"2011","Newcastle-under-Lyme 012","E02006169","Total",2167,1346,750,596,7,480,134,346,303,235,19,23,26,31
"2011","Newcastle-under-Lyme 013","E02006170","Total",2236,1725,941,784,5,240,65,175,238,218,1,16,3,28
"2011","Newcastle-under-Lyme 014","E02006171","Total",4000,2803,1547,1256,12,856,301,555,280,242,0,29,9,49
"2011","Newcastle-under-Lyme 015","E02006172","Total",4171,3617,2066,1551,43,251,59,192,217,193,3,19,2,43
"2011","Newcastle-under-Lyme 016","E02006173","Total",2841,2389,1363,1026,6,155,36,119,245,214,10,14,7,46
"2011","South Staffordshire 001","E02006174","Total",4264,3283,1784,1499,5,466,65,401,438,400,9,26,3,72
"2011","South Staffordshire 002","E02006175","Total",2641,1802,742,1060,77,514,60,454,220,186,7,23,4,28
"2011","South Staffordshire 003","E02006176","Total",3146,2258,1336,922,18,348,8,340,442,401,17,15,9,80
"2011","South Staffordshire 004","E02006177","Total",3968,3239,1661,1578,18,442,45,397,242,208,2,28,4,27
"2011","South Staffordshire 005","E02006178","Total",3198,2312,1142,1170,3,627,70,557,217,190,1,25,1,39
"2011","South Staffordshire 006","E02006179","Total",2787,2303,1193,1110,11,241,22,219,197,174,6,12,5,35
"2011","South Staffordshire 007","E02006180","Total",2590,1852,932,920,5,546,59,487,162,140,1,19,2,25
"2011","South Staffordshire 008","E02006181","Total",2567,1585,878,707,24,769,71,698,152,130,4,17,1,37
"2011","South Staffordshire 009","E02006182","Total",2751,2396,1344,1052,2,121,14,107,199,182,3,10,4,33
"2011","South Staffordshire 010","E02006183","Total",3090,2551,1222,1329,26,147,17,130,339,303,6,16,14,27
"2011","South Staffordshire 011","E02006184","Total",2274,1514,621,893,23,505,51,454,211,192,1,16,2,21
"2011","South Staffordshire 012","E02006185","Total",3113,1984,1106,878,17,793,86,707,277,255,6,14,2,42
"2011","South Staffordshire 013","E02006186","Total",4995,4158,2388,1770,16,361,50,311,401,363,6,26,6,59
"2011","South Staffordshire 014","E02006187","Total",3074,2432,1460,972,4,313,28,285,275,247,7,18,3,50
"2011","Stafford 001","E02006188","Total",2521,2082,1187,895,13,236,110,126,162,144,1,17,0,28
"2011","Stafford 002","E02006189","Total",3086,2371,1389,982,2,347,157,190,303,271,10,17,5,63
"2011","Stafford 003","E02006190","Total",4676,3047,1499,1548,17,771,215,556,776,704,6,55,11,65
"2011","Stafford 004","E02006191","Total",3268,2786,1420,1366,8,110,21,89,315,284,6,22,3,49
"2011","Stafford 005","E02006192","Total",3388,2616,1429,1187,14,316,134,182,392,338,20,29,5,50
"2011","Stafford 006","E02006193","Total",2780,2379,1295,1084,8,123,67,56,244,224,2,18,0,26
"2011","Stafford 007","E02006194","Total",3222,1969,943,1026,17,835,231,604,364,336,2,25,1,37
"2011","Stafford 008","E02006195","Total",3543,2927,1541,1386,21,258,63,195,291,254,7,24,6,46
"2011","Stafford 009","E02006196","Total",2856,1180,471,709,21,774,242,532,836,493,75,44,224,45
"2011","Stafford 010","E02006197","Total",4233,1875,707,1168,28,712,126,586,1561,1445,23,77,16,57
"2011","Stafford 011","E02006198","Total",3111,2618,1326,1292,15,48,5,43,403,355,24,17,7,27
"2011","Stafford 012","E02006199","Total",3359,2800,1370,1430,19,205,68,137,311,292,2,14,3,24
"2011","Stafford 013","E02006200","Total",3546,1708,690,1018,34,1489,470,1019,268,232,1,30,5,47
"2011","Stafford 014","E02006201","Total",5006,4600,2615,1985,19,37,2,35,306,272,3,30,1,44
"2011","Stafford 015","E02006202","Total",3641,2929,1547,1382,2,307,141,166,337,289,10,25,13,66
"2011","Stafford 016","E02006203","Total",3467,1993,830,1163,41,1050,368,682,337,306,1,22,8,46
"2011","Staffordshire Moorlands 001","E02006204","Total",3127,2171,1225,946,15,599,225,374,299,258,3,32,6,43
"2011","Staffordshire Moorlands 002","E02006205","Total",3058,2808,1667,1141,6,37,11,26,181,147,1,30,3,26
"2011","Staffordshire Moorlands 003","E02006206","Total",3424,2066,824,1242,6,839,348,491,474,432,3,36,3,39
"2011","Staffordshire Moorlands 004","E02006207","Total",2785,2516,1552,964,11,83,24,59,149,124,1,21,3,26
"2011","Staffordshire Moorlands 005","E02006208","Total",3911,2409,1134,1275,22,536,136,400,881,800,4,70,7,63
"2011","Staffordshire Moorlands 006","E02006209","Total",4594,3913,2073,1840,5,267,71,196,356,332,3,20,1,53
"2011","Staffordshire Moorlands 007","E02006210","Total",2377,1855,1188,667,13,156,43,113,290,237,6,30,17,63
"2011","Staffordshire Moorlands 008","E02006211","Total",2708,2439,1526,913,0,90,33,57,159,147,2,8,2,20
"2011","Staffordshire Moorlands 009","E02006212","Total",3307,3021,1784,1237,6,69,23,46,177,143,7,25,2,34
"2011","Staffordshire Moorlands 010","E02006213","Total",2844,2121,1184,937,12,389,167,222,269,238,2,25,4,53
"2011","Staffordshire Moorlands 011","E02006214","Total",2685,1962,1042,920,10,368,155,213,314,265,5,36,8,31
"2011","Staffordshire Moorlands 012","E02006215","Total",3382,2917,1650,1267,6,137,60,77,271,235,6,29,1,51
"2011","Staffordshire Moorlands 013","E02006216","Total",3570,3090,1564,1526,15,129,47,82,283,237,3,37,6,53
"2011","Tamworth 001","E02006217","Total",3649,2912,1559,1353,5,446,374,72,253,218,0,31,4,33
"2011","Tamworth 002","E02006218","Total",3877,1760,867,893,29,1270,904,366,745,692,2,40,11,73
"2011","Tamworth 003","E02006219","Total",3101,2184,854,1330,3,627,454,173,262,235,2,24,1,25
"2011","Tamworth 004","E02006220","Total",3167,2341,1162,1179,8,491,446,45,288,261,1,24,2,39
"2011","Tamworth 005","E02006221","Total",2540,1823,636,1187,48,205,155,50,446,415,1,26,4,18
"2011","Tamworth 006","E02006222","Total",2716,1763,687,1076,7,594,501,93,329,299,0,27,3,23
"2011","Tamworth 007","E02006223","Total",2756,1054,278,776,14,1425,959,466,235,205,0,30,0,28
"2011","Tamworth 008","E02006224","Total",2946,2354,678,1676,5,330,193,137,241,228,1,11,1,16
"2011","Tamworth 009","E02006225","Total",3013,2559,1101,1458,9,148,89,59,276,242,3,30,1,21
"2011","Tamworth 010","E02006226","Total",3852,2825,968,1857,30,572,407,165,401,362,4,29,6,24
"2011","North Warwickshire 001","E02006468","Total",4174,3284,1527,1757,11,465,417,48,377,330,10,33,4,37
"2011","North Warwickshire 002","E02006469","Total",3507,2238,1053,1185,56,738,477,261,440,409,3,22,6,35
"2011","North Warwickshire 003","E02006470","Total",4824,3011,1519,1492,29,1103,804,299,611,570,2,31,8,70
"2011","North Warwickshire 004","E02006471","Total",2864,2366,1231,1135,22,237,161,76,207,179,5,20,3,32
"2011","North Warwickshire 005","E02006472","Total",3703,2627,1229,1398,30,577,388,189,414,374,5,29,6,55
"2011","North Warwickshire 006","E02006473","Total",4275,3303,1575,1728,27,387,257,130,507,455,7,39,6,51
"2011","North Warwickshire 007","E02006474","Total",2465,1857,873,984,1,212,183,29,357,318,2,24,13,38
"2011","Nuneaton and Bedworth 001","E02006475","Total",3080,2574,1416,1158,4,262,257,5,219,196,1,22,0,21
"2011","Nuneaton and Bedworth 002","E02006476","Total",3075,1753,774,979,14,802,639,163,462,415,10,32,5,44
"2011","Nuneaton and Bedworth 003","E02006477","Total",2733,2470,1267,1203,9,50,19,31,188,166,2,20,0,16
"2011","Nuneaton and Bedworth 004","E02006478","Total",3176,2630,882,1748,30,146,83,63,353,316,2,32,3,17
"2011","Nuneaton and Bedworth 005","E02006479","Total",3982,2051,954,1097,42,736,426,310,1107,1027,5,53,22,46
"2011","Nuneaton and Bedworth 006","E02006480","Total",3184,1957,832,1125,8,784,651,133,395,364,2,24,5,40
"2011","Nuneaton and Bedworth 007","E02006481","Total",2885,1934,838,1096,3,487,453,34,432,396,0,35,1,29
"2011","Nuneaton and Bedworth 008","E02006482","Total",2797,2113,899,1214,27,188,76,112,444,408,2,30,4,25
"2011","Nuneaton and Bedworth 009","E02006483","Total",3235,1702,836,866,20,1023,847,176,439,400,0,35,4,51
"2011","Nuneaton and Bedworth 010","E02006484","Total",3292,2125,874,1251,6,588,364,224,546,483,5,54,4,27
"2011","Nuneaton and Bedworth 011","E02006485","Total",2807,2637,1395,1242,9,9,7,2,142,131,1,9,1,10
"2011","Nuneaton and Bedworth 012","E02006486","Total",2966,2314,1037,1277,25,307,281,26,293,262,3,27,1,27
"2011","Nuneaton and Bedworth 013","E02006487","Total",2985,1834,961,873,4,859,595,264,239,209,1,24,5,49
"2011","Nuneaton and Bedworth 014","E02006488","Total",2794,2322,1465,857,6,243,185,58,199,171,12,13,3,24
"2011","Nuneaton and Bedworth 015","E02006489","Total",3341,2265,868,1397,44,467,383,84,537,483,3,46,5,28
"2011","Nuneaton and Bedworth 016","E02006490","Total",3074,2381,1043,1338,14,344,241,103,311,278,0,32,1,24
"2011","Nuneaton and Bedworth 018","E02006806","Total",3305,2555,1204,1351,5,338,278,60,377,336,3,34,4,30
"2011","Rugby 001","E02006492","Total",4405,3253,1542,1711,17,383,255,128,694,514,79,24,77,58
"2011","Rugby 002","E02006493","Total",3671,2383,770,1613,56,737,364,373,474,446,1,19,8,21
"2011","Rugby 003","E02006494","Total",3075,1389,656,733,17,1021,724,297,593,559,3,25,6,55
"2011","Rugby 004","E02006495","Total",3195,2616,1352,1264,33,280,204,76,235,214,2,14,5,31
"2011","Rugby 005","E02006496","Total",3033,1616,613,1003,28,351,246,105,1012,948,6,56,2,26
"2011","Rugby 006","E02006497","Total",3388,1890,741,1149,83,586,308,278,800,748,7,37,8,29
"2011","Rugby 007","E02006498","Total",4435,3234,1160,2074,68,668,242,426,437,412,2,22,1,28
"2011","Rugby 008","E02006499","Total",2463,2152,1057,1095,43,50,10,40,199,182,2,14,1,19
"2011","Rugby 009","E02006500","Total",2358,1418,799,619,11,438,229,209,421,343,52,15,11,70
"2011","Rugby 010","E02006501","Total",3895,2944,1469,1475,3,535,461,74,360,313,6,36,5,53
"2011","Rugby 011","E02006502","Total",4648,3491,1991,1500,32,665,565,100,409,373,5,27,4,51
"2011","Rugby 012","E02006503","Total",3309,2700,1622,1078,12,279,252,27,269,229,9,22,9,49
"2011","Stratford-on-Avon 001","E02006504","Total",2287,1858,1076,782,14,162,6,156,210,170,16,16,8,43
"2011","Stratford-on-Avon 002","E02006505","Total",3044,2330,1479,851,18,369,39,330,288,269,2,13,4,39
"2011","Stratford-on-Avon 003","E02006506","Total",2513,1786,937,849,24,374,43,331,284,246,1,28,9,45
"2011","Stratford-on-Avon 004","E02006507","Total",3759,2760,1360,1400,48,553,40,513,368,325,7,31,5,30
"2011","Stratford-on-Avon 005","E02006508","Total",3920,2998,1540,1458,36,420,36,384,405,359,6,25,15,61
"2011","Stratford-on-Avon 006","E02006509","Total",2752,1733,928,805,18,583,60,523,369,333,9,20,7,49
"2011","Stratford-on-Avon 007","E02006510","Total",2606,2172,1322,850,24,152,19,133,229,201,10,16,2,29
"2011","Stratford-on-Avon 008","E02006511","Total",3815,2796,1489,1307,21,550,42,508,384,325,20,31,8,64
"2011","Stratford-on-Avon 009","E02006512","Total",5000,2912,1512,1400,86,947,91,856,1012,946,11,49,6,43
"2011","Stratford-on-Avon 010","E02006513","Total",3168,2424,1272,1152,57,209,10,199,447,399,11,28,9,31
"2011","Stratford-on-Avon 011","E02006514","Total",4226,2840,1697,1143,52,444,28,416,841,786,12,30,13,49
"2011","Stratford-on-Avon 012","E02006515","Total",3769,2833,1472,1361,73,428,39,389,390,351,13,14,12,45
"2011","Stratford-on-Avon 013","E02006516","Total",3740,2624,1360,1264,18,536,55,481,485,389,46,21,29,77
"2011","Stratford-on-Avon 014","E02006517","Total",3088,2242,1145,1097,32,364,33,331,400,353,17,20,10,50
"2011","Stratford-on-Avon 015","E02006518","Total",4241,2996,1726,1270,40,622,53,569,484,433,10,33,8,99
"2011","Warwick 001","E02006519","Total",3487,2654,1490,1164,8,236,178,58,546,507,0,32,7,43
"2011","Warwick 002","E02006520","Total",3658,2939,1475,1464,60,186,129,57,441,408,3,24,6,32
"2011","Warwick 003","E02006521","Total",3236,2640,1561,1079,9,292,227,65,269,248,0,19,2,26
"2011","Warwick 004","E02006522","Total",2327,1821,988,833,8,154,115,39,283,254,9,16,4,61
"2011","Warwick 005","E02006523","Total",4228,3297,1805,1492,22,315,235,80,531,440,44,19,28,63
"2011","Warwick 006","E02006524","Total",2442,1303,619,684,6,928,855,73,165,152,0,12,1,40
"2011","Warwick 007","E02006525","Total",5845,3475,1750,1725,45,634,372,262,1635,1549,15,54,17,56
"2011","Warwick 008","E02006526","Total",3630,2592,1269,1323,15,606,407,199,388,349,0,35,4,29
"2011","Warwick 009","E02006527","Total",4115,2521,1246,1275,13,427,184,243,1109,1058,5,37,9,45
"2011","Warwick 010","E02006528","Total",4693,2459,1107,1352,65,805,334,471,1317,1262,3,43,9,47
"2011","Warwick 011","E02006529","Total",5238,2885,1128,1757,142,1030,884,146,1110,1008,28,65,9,71
"2011","Warwick 012","E02006530","Total",4480,3236,1513,1723,29,463,173,290,713,676,6,27,4,39
"2011","Warwick 013","E02006531","Total",3865,1508,604,904,16,1122,888,234,1159,1096,6,45,12,60
"2011","Warwick 014","E02006532","Total",3587,2861,1279,1582,40,284,156,128,367,334,10,18,5,35
"2011","Warwick 015","E02006533","Total",3848,2920,1323,1597,32,384,200,184,480,445,5,29,1,32
"2011","Birmingham 001","E02001827","Total",2578,2033,1087,946,6,306,126,180,207,187,4,16,0,26
"2011","Birmingham 002","E02001828","Total",3141,2458,1398,1060,5,278,231,47,359,331,5,21,2,41
"2011","Birmingham 003","E02001829","Total",3446,3063,1534,1529,13,96,43,53,255,234,2,18,1,19
"2011","Birmingham 004","E02001830","Total",3954,3360,1937,1423,5,149,33,116,406,388,0,17,1,34
"2011","Birmingham 005","E02001831","Total",4399,2714,1146,1568,55,1177,666,511,399,357,7,30,5,54
"2011","Birmingham 006","E02001832","Total",3437,2751,1329,1422,25,274,155,119,345,317,9,18,1,42
"2011","Birmingham 007","E02001833","Total",2288,1944,975,969,5,176,66,110,146,135,2,7,2,17
"2011","Birmingham 008","E02001834","Total",2480,1597,685,912,6,527,470,57,304,273,3,28,0,46
"2011","Birmingham 009","E02001835","Total",3496,2575,1260,1315,13,156,142,14,708,668,3,34,3,44
"2011","Birmingham 010","E02001836","Total",3672,3083,1549,1534,6,216,137,79,344,323,2,17,2,23
"2011","Birmingham 011","E02001837","Total",4098,1976,734,1242,25,1534,1431,103,493,457,1,32,3,70
"2011","Birmingham 012","E02001838","Total",3082,2740,1319,1421,9,60,27,33,238,221,0,15,2,35
"2011","Birmingham 013","E02001839","Total",2810,2005,940,1065,4,393,231,162,376,342,0,33,1,32
"2011","Birmingham 014","E02001840","Total",3586,1549,572,977,62,1462,1085,377,435,397,4,29,5,78
"2011","Birmingham 015","E02001841","Total",2414,2186,1282,904,4,26,11,15,177,163,1,11,2,21
"2011","Birmingham 016","E02001842","Total",3024,2464,1216,1248,11,124,105,19,397,371,0,24,2,28
"2011","Birmingham 017","E02001843","Total",2713,2207,1088,1119,15,44,15,29,420,382,2,34,2,27
"2011","Birmingham 018","E02001844","Total",4459,2826,1314,1512,159,600,288,312,826,773,4,44,5,48
"2011","Birmingham 019","E02001845","Total",2575,1977,727,1250,12,161,23,138,409,378,0,28,3,16
"2011","Birmingham 020","E02001846","Total",3359,1810,712,1098,42,970,824,146,475,448,1,22,4,62
"2011","Birmingham 021","E02001847","Total",2399,1931,942,989,7,156,104,52,283,250,10,15,8,22
"2011","Birmingham 022","E02001848","Total",2545,1411,618,793,14,739,619,120,336,316,2,13,5,45
"2011","Birmingham 023","E02001849","Total",3211,1446,614,832,21,937,774,163,753,719,4,27,3,54
"2011","Birmingham 024","E02001850","Total",3059,2256,1057,1199,11,173,110,63,578,531,0,45,2,41
"2011","Birmingham 025","E02001851","Total",3705,2258,864,1394,32,929,555,374,417,376,0,36,5,69
"2011","Birmingham 026","E02001852","Total",2687,1676,741,935,40,408,233,175,519,488,0,27,4,44
"2011","Birmingham 028","E02001854","Total",3252,2007,872,1135,28,668,456,212,491,460,4,26,1,58
"2011","Birmingham 029","E02001855","Total",4247,1568,722,846,20,2368,207,2161,229,208,2,13,6,62
"2011","Birmingham 030","E02001856","Total",3451,2074,816,1258,33,296,136,160,1001,948,4,46,3,47
"2011","Birmingham 031","E02001857","Total",5340,2259,937,1322,110,1306,621,685,1579,1516,4,54,5,86
"2011","Birmingham 032","E02001858","Total",3126,1373,660,713,19,780,214,566,900,875,2,16,7,54
"2011","Birmingham 033","E02001859","Total",2722,1469,818,651,13,470,189,281,694,650,5,23,16,76
"2011","Birmingham 034","E02001860","Total",2852,1445,763,682,13,596,169,427,737,669,1,31,36,61
"2011","Birmingham 035","E02001861","Total",3160,1193,704,489,28,1203,251,952,652,609,2,26,15,84
"2011","Birmingham 036","E02001862","Total",3337,1571,834,737,31,945,359,586,716,657,3,41,15,74
"2011","Birmingham 037","E02001863","Total",2350,1083,583,500,10,754,447,307,436,408,2,16,10,67
"2011","Birmingham 038","E02001864","Total",2248,793,308,485,43,1156,1037,119,199,185,1,11,2,57
"2011","Birmingham 039","E02001865","Total",3324,1653,968,685,24,835,185,650,721,653,6,42,20,91
"2011","Birmingham 040","E02001866","Total",2576,955,493,462,18,1140,271,869,406,384,0,9,13,57
"2011","Birmingham 041","E02001867","Total",2076,761,331,430,27,1020,631,389,212,195,0,14,3,56
"2011","Birmingham 042","E02001868","Total",2637,2120,1087,1033,7,109,86,23,367,341,3,19,4,34
"2011","Birmingham 043","E02001869","Total",2433,459,198,261,27,1721,1276,445,170,149,1,10,10,56
"2011","Birmingham 044","E02001870","Total",3575,2349,1082,1267,16,469,392,77,683,630,2,42,9,58
"2011","Birmingham 045","E02001871","Total",3543,1582,773,809,131,1470,1133,337,275,252,1,17,5,85
"2011","Birmingham 046","E02001872","Total",3128,1553,679,874,77,1164,935,229,245,216,1,24,4,89
"2011","Birmingham 047","E02001873","Total",3949,1417,719,698,21,1331,570,761,1059,1000,3,36,20,121
"2011","Birmingham 048","E02001874","Total",2737,1249,675,574,20,956,527,429,433,402,0,25,6,79
"2011","Birmingham 049","E02001875","Total",3264,717,272,445,19,1697,1239,458,734,698,0,20,16,97
"2011","Birmingham 050","E02001876","Total",3136,445,165,280,12,1882,1581,301,684,633,9,15,27,113
"2011","Birmingham 051","E02001877","Total",2867,1379,758,621,14,852,303,549,546,507,2,30,7,76
"2011","Birmingham 052","E02001878","Total",2707,1073,585,488,25,1008,543,465,525,494,0,21,10,76
"2011","Birmingham 053","E02001879","Total",3155,1228,634,594,25,1008,569,439,826,789,7,19,11,68
"2011","Birmingham 054","E02001880","Total",3479,1550,501,1049,39,1396,1168,228,427,387,1,35,4,67
"2011","Birmingham 055","E02001881","Total",2943,1428,655,773,8,945,878,67,476,452,3,14,7,86
"2011","Birmingham 056","E02001882","Total",3144,1710,828,882,18,827,489,338,556,526,0,25,5,33
"2011","Birmingham 057","E02001883","Total",3615,1663,667,996,13,1437,1264,173,423,389,2,29,3,79
"2011","Birmingham 058","E02001884","Total",2447,1307,582,725,32,514,283,231,534,498,1,25,10,60
"2011","Birmingham 060","E02001886","Total",3231,1594,798,796,38,377,157,220,1176,1136,9,23,8,46
"2011","Birmingham 062","E02001888","Total",2400,1359,557,802,7,726,622,104,271,237,0,30,4,37
"2011","Birmingham 063","E02001889","Total",2276,1274,611,663,8,415,257,158,529,496,0,21,12,50
"2011","Birmingham 064","E02001890","Total",4450,1696,890,806,22,754,330,424,1901,1837,4,34,26,77
"2011","Birmingham 066","E02001892","Total",3534,1631,656,975,23,1304,1158,146,500,458,0,31,11,76
"2011","Birmingham 067","E02001893","Total",3168,2221,1064,1157,13,515,356,159,379,335,0,38,6,40
"2011","Birmingham 069","E02001895","Total",3259,1739,822,917,23,1138,965,173,282,250,4,26,2,77
"2011","Birmingham 070","E02001896","Total",2422,1293,715,578,12,393,74,319,661,615,1,28,17,63
"2011","Birmingham 071","E02001897","Total",2818,696,359,337,21,1671,1060,611,331,302,4,13,12,99
"2011","Birmingham 072","E02001898","Total",2664,2280,1071,1209,14,119,83,36,224,201,1,20,2,27
"2011","Birmingham 073","E02001899","Total",3216,2472,1334,1138,34,190,33,157,472,437,5,28,2,48
"2011","Birmingham 074","E02001900","Total",2625,1015,546,469,15,944,458,486,583,545,4,20,14,68
"2011","Birmingham 075","E02001901","Total",3677,2067,980,1087,50,369,132,237,1124,1067,5,41,11,67
"2011","Birmingham 076","E02001902","Total",2487,1806,790,1016,25,297,269,28,337,311,2,21,3,22
"2011","Birmingham 077","E02001903","Total",2016,875,519,356,12,684,211,473,379,348,2,16,13,66
"2011","Birmingham 078","E02001904","Total",2618,1422,563,859,12,453,355,98,687,647,5,20,15,44
"2011","Birmingham 079","E02001905","Total",2578,1522,795,727,5,156,35,121,814,729,23,20,42,81
"2011","Birmingham 080","E02001906","Total",3798,2791,1360,1431,17,507,423,84,441,406,2,30,3,42
"2011","Birmingham 081","E02001907","Total",4115,3037,1526,1511,14,479,442,37,533,481,3,44,5,52
"2011","Birmingham 082","E02001908","Total",2178,1256,715,541,6,387,151,236,474,432,2,30,10,55
"2011","Birmingham 083","E02001909","Total",2298,995,527,468,7,728,224,504,510,482,0,20,8,58
"2011","Birmingham 084","E02001910","Total",2330,854,477,377,12,905,367,538,511,478,2,21,10,48
"2011","Birmingham 085","E02001911","Total",3317,1405,601,804,9,1446,1363,83,376,352,3,17,4,81
"2011","Birmingham 087","E02001913","Total",3289,1277,719,558,20,969,736,233,955,909,0,40,6,68
"2011","Birmingham 088","E02001914","Total",2195,1310,677,633,16,321,144,177,507,489,3,10,5,41
"2011","Birmingham 089","E02001915","Total",4852,2634,1015,1619,117,857,450,407,1173,1106,3,55,9,71
"2011","Birmingham 090","E02001916","Total",3085,1703,754,949,16,707,638,69,612,576,2,26,8,47
"2011","Birmingham 092","E02001918","Total",4081,1689,781,908,17,1104,157,947,1226,1184,1,32,9,45
"2011","Birmingham 093","E02001919","Total",2624,1498,792,706,16,271,47,224,796,741,1,30,24,43
"2011","Birmingham 094","E02001920","Total",3256,1660,758,902,19,1252,1223,29,259,237,0,15,7,66
"2011","Birmingham 095","E02001921","Total",3283,1864,876,988,12,916,797,119,433,401,1,25,6,58
"2011","Birmingham 096","E02001922","Total",2994,476,298,178,19,328,180,148,2138,2081,4,30,23,33
"2011","Birmingham 097","E02001923","Total",3380,2293,1208,1085,7,369,162,207,651,599,7,33,12,60
"2011","Birmingham 098","E02001924","Total",2396,1586,723,863,8,442,403,39,301,278,0,19,4,59
"2011","Birmingham 099","E02001925","Total",2812,1697,903,794,9,530,174,356,532,493,7,24,8,44
"2011","Birmingham 100","E02001926","Total",2829,1559,828,731,16,329,101,228,881,780,22,56,23,44
"2011","Birmingham 101","E02001927","Total",3205,1610,660,950,67,1096,868,228,367,334,5,19,9,65
"2011","Birmingham 102","E02001928","Total",3003,1546,663,883,21,1150,954,196,219,194,0,23,2,67
"2011","Birmingham 103","E02001929","Total",3690,1854,670,1184,5,1286,1207,79,461,425,0,33,3,84
"2011","Birmingham 104","E02001930","Total",3203,2192,960,1232,11,266,174,92,689,652,2,33,2,45
"2011","Birmingham 105","E02001931","Total",3067,2262,1181,1081,5,385,256,129,384,346,0,34,4,31
"2011","Birmingham 106","E02001932","Total",2853,1199,524,675,159,1192,848,344,239,210,2,19,8,64
"2011","Birmingham 107","E02001933","Total",3119,1982,799,1183,16,661,515,146,423,376,5,40,2,37
"2011","Birmingham 108","E02001934","Total",2297,1858,948,910,6,103,97,6,304,279,1,22,2,26
"2011","Birmingham 109","E02001935","Total",3238,1938,1086,852,44,939,174,765,286,250,3,18,15,31
"2011","Birmingham 110","E02001936","Total",2570,1931,1038,893,10,359,284,75,236,209,7,12,8,34
"2011","Birmingham 111","E02001937","Total",3249,1696,773,923,61,1083,955,128,346,312,0,30,4,63
"2011","Birmingham 112","E02001938","Total",3286,2022,718,1304,48,473,87,386,711,661,2,41,7,32
"2011","Birmingham 113","E02001939","Total",2882,939,517,422,37,1572,429,1143,299,273,5,7,14,35
"2011","Birmingham 115","E02001941","Total",2519,1348,598,750,26,802,724,78,285,259,1,22,3,58
"2011","Birmingham 116","E02001942","Total",2971,1700,807,893,84,613,399,214,549,519,5,22,3,25
"2011","Birmingham 117","E02001943","Total",2593,1645,692,953,86,544,369,175,285,270,4,11,0,33
"2011","Birmingham 118","E02001944","Total",3411,2181,908,1273,178,562,362,200,446,413,2,27,4,44
"2011","Birmingham 119","E02001945","Total",3098,1530,522,1008,40,1178,1113,65,300,270,0,27,3,50
"2011","Birmingham 120","E02001946","Total",3193,2508,1238,1270,24,315,139,176,321,296,2,22,1,25
"2011","Birmingham 121","E02001947","Total",2869,1067,466,601,7,1567,1485,82,138,122,1,13,2,90
"2011","Birmingham 122","E02001948","Total",3073,2305,1028,1277,31,347,289,58,364,334,0,30,0,26
"2011","Birmingham 123","E02001949","Total",2483,1452,600,852,8,695,524,171,306,288,1,16,1,22
"2011","Birmingham 124","E02001950","Total",3608,2602,1273,1329,54,435,249,186,485,457,1,27,0,32
"2011","Birmingham 125","E02001951","Total",3573,1409,465,944,47,1850,1640,210,189,176,1,12,0,78
"2011","Birmingham 126","E02001952","Total",4055,1535,651,884,110,1923,1454,469,380,344,5,24,7,107
"2011","Birmingham 127","E02001953","Total",2963,2220,1124,1096,21,484,464,20,205,179,2,23,1,33
"2011","Birmingham 128","E02001954","Total",3400,1338,499,839,26,1705,1604,101,250,223,3,22,2,81
"2011","Birmingham 129","E02001955","Total",2738,1573,580,993,56,700,401,299,385,353,1,26,5,24
"2011","Birmingham 130","E02001956","Total",2684,1904,744,1160,21,382,339,43,337,303,1,33,0,40
"2011","Birmingham 131","E02001957","Total",3283,2562,1179,1383,27,341,229,112,325,288,1,32,4,28
"2011","Birmingham 132","E02006807","Total",3013,2459,1142,1317,15,65,60,5,440,411,2,25,2,34
"2011","Birmingham 133","E02006809","Total",3083,2572,1289,1283,10,95,57,38,366,348,3,14,1,40
"2011","Birmingham 134","E02006895","Total",3179,589,187,402,58,1385,379,1006,1084,1044,6,24,10,63
"2011","Birmingham 135","E02006896","Total",3102,448,159,289,109,902,195,707,1599,1556,4,28,11,44
"2011","Birmingham 136","E02006897","Total",3150,466,168,298,17,1591,865,726,994,959,1,20,14,82
"2011","Birmingham 137","E02006898","Total",3371,833,270,563,66,960,867,93,1465,1415,5,34,11,47
"2011","Birmingham 138","E02006899","Total",3433,587,177,410,46,440,111,329,2317,2249,8,39,21,43
"2011","Birmingham 139","E02006900","Total",4067,2033,1086,947,31,1021,451,570,883,808,3,45,27,99
"2011","Birmingham 140","E02006901","Total",4174,2446,1110,1336,33,379,191,188,1243,1181,1,47,14,73
"2011","Coventry 001","E02001958","Total",3268,1997,892,1105,19,420,75,345,791,743,3,38,7,41
"2011","Coventry 002","E02001959","Total",2378,1900,984,916,11,78,18,60,374,336,1,36,1,15
"2011","Coventry 004","E02001961","Total",3277,1546,719,827,15,1160,491,669,524,476,1,42,5,32
"2011","Coventry 005","E02001962","Total",2215,1259,592,667,5,335,80,255,577,537,4,28,8,39
"2011","Coventry 006","E02001963","Total",2441,1898,956,942,4,259,91,168,260,226,5,28,1,20
"2011","Coventry 007","E02001964","Total",3282,984,463,521,21,1924,864,1060,312,280,1,26,5,41
"2011","Coventry 008","E02001965","Total",3309,2286,1020,1266,68,440,60,380,475,450,1,20,4,40
"2011","Coventry 009","E02001966","Total",2228,1061,558,503,14,364,62,302,734,686,2,35,11,55
"2011","Coventry 010","E02001967","Total",2648,2195,1230,965,10,143,53,90,274,242,2,24,6,26
"2011","Coventry 011","E02001968","Total",2693,1793,763,1030,8,124,59,65,741,674,2,56,9,27
"2011","Coventry 012","E02001969","Total",2677,1530,674,856,10,548,246,302,554,509,2,36,7,35
"2011","Coventry 013","E02001970","Total",2474,1816,1105,711,8,112,46,66,507,470,1,34,2,31
"2011","Coventry 014","E02001971","Total",2401,1853,879,974,1,224,72,152,303,275,2,25,1,20
"2011","Coventry 015","E02001972","Total",3644,1149,617,532,24,1283,221,1062,1110,1042,5,35,28,78
"2011","Coventry 016","E02001973","Total",3414,1667,646,1021,15,867,345,522,832,760,3,51,18,33
"2011","Coventry 017","E02001974","Total",3906,3127,1512,1615,24,69,15,54,655,601,3,45,6,31
"2011","Coventry 018","E02001975","Total",2974,2392,1087,1305,8,51,17,34,500,464,0,32,4,23
"2011","Coventry 019","E02001976","Total",3126,1830,904,926,23,644,209,435,600,545,16,31,8,29
"2011","Coventry 020","E02001977","Total",4097,1350,527,823,39,996,329,667,1637,1518,4,51,64,75
"2011","Coventry 021","E02001978","Total",2538,1845,830,1015,7,57,17,40,596,559,0,35,2,33
"2011","Coventry 022","E02001979","Total",2465,2140,1170,970,4,19,7,12,279,260,1,16,2,23
"2011","Coventry 023","E02001980","Total",2568,2291,1292,999,2,12,4,8,245,229,0,16,0,18
"2011","Coventry 024","E02001981","Total",4334,1079,555,524,33,1510,324,1186,1603,1525,3,37,38,109
"2011","Coventry 025","E02001982","Total",3068,2223,981,1242,59,410,24,386,349,322,1,24,2,27
"2011","Coventry 026","E02001983","Total",3268,2453,1085,1368,10,228,94,134,551,508,0,32,11,26
"2011","Coventry 027","E02001984","Total",3515,2479,1100,1379,15,211,59,152,776,726,3,37,10,34
"2011","Coventry 028","E02001985","Total",3071,931,460,471,19,440,114,326,1642,1553,10,52,27,39
"2011","Coventry 029","E02001986","Total",3587,1741,775,966,19,1382,529,853,378,333,1,34,10,67
"2011","Coventry 030","E02001987","Total",2609,1233,526,707,19,125,17,108,1210,1108,2,55,45,22
"2011","Coventry 031","E02001988","Total",3562,883,419,464,54,1035,208,827,1537,1431,8,31,67,53
"2011","Coventry 032","E02001989","Total",2296,1718,747,971,5,109,47,62,444,403,4,34,3,20
"2011","Coventry 033","E02001990","Total",3661,3108,1542,1566,16,133,44,89,377,338,3,34,2,27
"2011","Coventry 034","E02001991","Total",3732,2714,1451,1263,30,160,16,144,800,706,2,28,64,28
"2011","Coventry 035","E02001992","Total",3879,1889,806,1083,40,1514,529,985,393,348,3,32,10,43
"2011","Coventry 036","E02001993","Total",2937,1583,676,907,9,961,368,593,336,304,1,21,10,48
"2011","Coventry 037","E02001994","Total",3398,2399,1215,1184,9,398,129,269,553,515,2,30,6,39
"2011","Coventry 038","E02001995","Total",3090,1856,835,1021,10,307,56,251,873,820,4,40,9,44
"2011","Coventry 039","E02001996","Total",3262,1072,500,572,24,1764,682,1082,357,326,1,22,8,45
"2011","Coventry 040","E02001997","Total",3464,2949,1757,1192,4,202,56,146,276,250,3,15,8,33
"2011","Coventry 041","E02001998","Total",2381,2137,1115,1022,6,38,12,26,180,161,1,17,1,20
"2011","Coventry 042","E02001999","Total",2258,1724,962,762,12,190,68,122,313,280,6,14,13,19
"2011","Coventry 043","E02006805","Total",3197,1800,717,1083,17,668,231,437,675,622,1,42,10,37
"2011","Dudley 001","E02002000","Total",3218,1907,933,974,5,1032,886,146,207,183,0,18,6,67
"2011","Dudley 002","E02002001","Total",2509,1632,793,839,6,624,548,76,202,191,1,8,2,45
"2011","Dudley 003","E02002002","Total",2982,2628,1664,964,13,189,146,43,117,99,0,16,2,35
"2011","Dudley 004","E02002003","Total",3766,2839,1524,1315,6,603,514,89,269,249,1,16,3,49
"2011","Dudley 005","E02002004","Total",2979,1701,806,895,75,900,673,227,229,210,2,15,2,74
"2011","Dudley 006","E02002005","Total",3024,1471,706,765,13,1249,1203,46,216,191,5,16,4,75
"2011","Dudley 007","E02002006","Total",2826,1586,726,860,51,934,681,253,207,186,2,16,3,48
"2011","Dudley 008","E02002007","Total",3796,2878,1718,1160,7,643,584,59,206,183,1,21,1,62
"2011","Dudley 009","E02002008","Total",3066,2720,965,1755,21,85,43,42,222,207,1,14,0,18
"2011","Dudley 010","E02002009","Total",2550,1143,502,641,5,1027,931,96,292,268,0,20,4,83
"2011","Dudley 011","E02002010","Total",3223,1373,709,664,49,1100,705,395,622,588,3,16,15,79
"2011","Dudley 012","E02002011","Total",2457,2213,1210,1003,7,67,47,20,146,130,2,12,2,24
"2011","Dudley 013","E02002012","Total",3278,1460,744,716,18,1400,1242,158,320,252,30,17,21,80
"2011","Dudley 014","E02002013","Total",2783,2419,1445,974,4,186,182,4,152,141,0,8,3,22
"2011","Dudley 015","E02002014","Total",2643,1529,753,776,8,637,542,95,409,378,5,21,5,60
"2011","Dudley 016","E02002015","Total",2429,1848,920,928,3,389,377,12,152,133,2,14,3,37
"2011","Dudley 017","E02002016","Total",3132,1540,707,833,8,1184,1114,70,310,286,2,20,2,90
"2011","Dudley 018","E02002017","Total",3550,2042,1001,1041,14,1011,861,150,432,404,4,20,4,51
"2011","Dudley 019","E02002018","Total",3707,3252,1913,1339,2,220,217,3,190,175,0,15,0,43
"2011","Dudley 020","E02002019","Total",3102,1799,893,906,6,988,947,41,240,221,0,17,2,69
"2011","Dudley 021","E02002020","Total",3980,3306,1669,1637,21,268,216,52,345,319,2,19,5,40
"2011","Dudley 022","E02002021","Total",3400,1343,528,815,19,1310,1125,185,653,618,4,25,6,75
"2011","Dudley 023","E02002022","Total",3418,2032,804,1228,16,922,826,96,385,341,3,37,4,63
"2011","Dudley 024","E02002023","Total",2221,1779,891,888,2,273,181,92,156,136,1,16,3,11
"2011","Dudley 025","E02002024","Total",3434,2365,1142,1223,25,625,592,33,351,319,7,23,2,68
"2011","Dudley 026","E02002025","Total",3319,2331,1074,1257,18,533,406,127,396,367,2,25,2,41
"2011","Dudley 027","E02002026","Total",2800,2340,1141,1199,78,148,134,14,213,179,2,30,2,21
"2011","Dudley 028","E02002027","Total",2223,2004,738,1266,30,17,14,3,163,151,0,12,0,9
"2011","Dudley 029","E02002028","Total",2587,1979,1127,852,5,406,389,17,153,140,0,10,3,44
"2011","Dudley 030","E02002029","Total",2468,2074,1195,879,8,176,95,81,189,166,0,22,1,21
"2011","Dudley 031","E02002030","Total",2690,1680,786,894,54,675,436,239,223,198,0,22,3,58
"2011","Dudley 032","E02002031","Total",2339,1782,817,965,13,94,62,32,434,406,0,26,2,16
"2011","Dudley 033","E02002032","Total",4050,2474,1045,1429,19,1014,859,155,462,422,3,33,4,81
"2011","Dudley 034","E02002033","Total",3190,2403,1240,1163,21,414,269,145,311,279,1,29,2,41
"2011","Dudley 035","E02002034","Total",3724,2298,1074,1224,16,764,713,51,571,530,6,32,3,75
"2011","Dudley 036","E02002035","Total",2490,2131,1188,943,0,208,194,14,114,100,2,12,0,37
"2011","Dudley 037","E02002036","Total",2773,1375,673,702,4,943,820,123,391,361,1,23,6,60
"2011","Dudley 038","E02002037","Total",2507,1884,966,918,5,424,418,6,149,129,1,18,1,45
"2011","Dudley 039","E02002038","Total",4231,2671,1369,1302,17,1014,842,172,446,412,2,30,2,83
"2011","Dudley 040","E02002039","Total",2562,1906,1049,857,6,305,262,43,304,277,3,19,5,41
"2011","Dudley 041","E02002040","Total",2510,2187,1303,884,0,144,99,45,151,136,4,11,0,28
"2011","Dudley 042","E02002041","Total",2570,2080,1292,788,5,341,339,2,114,104,0,9,1,30
"2011","Dudley 043","E02002042","Total",3361,2900,1640,1260,4,233,140,93,190,173,0,15,2,34
"2011","Sandwell 001","E02002043","Total",3165,1827,781,1046,4,927,852,75,323,290,1,30,2,84
"2011","Sandwell 002","E02002044","Total",2834,1701,631,1070,10,755,556,199,324,306,0,16,2,44
"2011","Sandwell 003","E02002045","Total",3201,1969,955,1014,9,900,821,79,254,233,1,19,1,69
"2011","Sandwell 004","E02002046","Total",2031,823,317,506,5,1033,1025,8,112,102,1,6,3,58
"2011","Sandwell 005","E02002047","Total",2787,1547,818,729,25,831,648,183,312,290,1,16,5,72
"2011","Sandwell 006","E02002048","Total",2635,2239,1258,981,9,121,83,38,239,220,3,15,1,27
"2011","Sandwell 007","E02002049","Total",2365,1555,688,867,14,573,458,115,200,185,0,14,1,23
"2011","Sandwell 009","E02002051","Total",2041,830,361,469,3,1003,792,211,149,142,1,5,1,56
"2011","Sandwell 010","E02002052","Total",4082,1995,878,1117,18,1503,1219,284,474,452,3,15,4,92
"2011","Sandwell 011","E02002053","Total",2477,1792,950,842,6,378,318,60,276,259,1,14,2,25
"2011","Sandwell 012","E02002054","Total",2274,1734,958,776,7,247,229,18,260,237,0,20,3,26
"2011","Sandwell 013","E02002055","Total",3519,1939,899,1040,36,1094,854,240,375,348,3,22,2,75
"2011","Sandwell 014","E02002056","Total",3532,1508,644,864,10,1628,1486,142,318,302,2,12,2,68
"2011","Sandwell 015","E02002057","Total",3655,1910,795,1115,69,1139,879,260,448,426,2,17,3,89
"2011","Sandwell 016","E02002058","Total",4622,2482,838,1644,23,1316,1175,141,705,667,3,27,8,96
"2011","Sandwell 017","E02002059","Total",4244,2264,1160,1104,27,1201,1039,162,661,608,12,27,14,91
"2011","Sandwell 018","E02002060","Total",2369,1077,557,520,24,918,821,97,282,253,2,24,3,68
"2011","Sandwell 019","E02002061","Total",2052,1060,595,465,25,536,389,147,384,360,0,17,7,47
"2011","Sandwell 020","E02002062","Total",2952,1064,599,465,19,1389,886,503,378,346,7,20,5,102
"2011","Sandwell 021","E02002063","Total",3583,2205,844,1361,20,597,404,193,701,665,3,28,5,60
"2011","Sandwell 022","E02002064","Total",4656,2905,1204,1701,13,1248,1200,48,413,379,1,28,5,77
"2011","Sandwell 023","E02002065","Total",3774,2056,1027,1029,25,784,458,326,815,734,0,54,27,94
"2011","Sandwell 024","E02002066","Total",2784,1452,673,779,18,712,519,193,534,512,0,15,7,68
"2011","Sandwell 025","E02002067","Total",2190,1585,824,761,11,429,399,30,138,122,0,12,4,27
"2011","Sandwell 026","E02002068","Total",4097,1445,579,866,17,1686,1168,518,814,776,0,29,9,135
"2011","Sandwell 027","E02002069","Total",2917,1541,767,774,7,1043,930,113,277,253,4,17,3,49
"2011","Sandwell 028","E02002070","Total",3487,1587,777,810,24,1050,648,402,714,683,1,26,4,112
"2011","Sandwell 029","E02002071","Total",2610,1485,676,809,15,840,781,59,212,191,2,16,3,58
"2011","Sandwell 030","E02002072","Total",3415,2240,1026,1214,8,560,427,133,534,486,1,38,9,73
"2011","Sandwell 031","E02002073","Total",2867,1532,685,847,16,1004,936,68,245,229,0,16,0,70
"2011","Sandwell 032","E02002074","Total",3109,1925,892,1033,4,817,789,28,301,272,3,24,2,62
"2011","Sandwell 033","E02002075","Total",3593,2078,901,1177,17,987,736,251,424,370,8,41,5,87
"2011","Sandwell 034","E02002076","Total",4479,2831,1217,1614,17,401,368,33,1170,1125,4,36,5,60
"2011","Sandwell 035","E02002077","Total",4282,2359,1049,1310,50,1221,951,270,575,534,9,26,6,77
"2011","Sandwell 036","E02002078","Total",2483,1972,1049,923,5,250,191,59,229,206,1,20,2,27
"2011","Sandwell 037","E02002079","Total",3375,2146,1032,1114,54,771,705,66,330,299,2,23,6,74
"2011","Sandwell 038","E02002080","Total",2783,1609,753,856,19,770,705,65,324,305,1,13,5,61
"2011","Sandwell 039","E02006810","Total",4177,2866,1596,1270,18,777,742,35,450,416,5,24,5,66
"2011","Solihull 001","E02002081","Total",2369,1784,956,828,19,391,84,307,162,141,0,19,2,13
"2011","Solihull 002","E02002082","Total",2441,1130,461,669,18,1082,937,145,196,181,0,13,2,15
"2011","Solihull 003","E02002083","Total",2339,2152,1205,947,29,28,17,11,117,102,2,11,2,13
"2011","Solihull 004","E02002084","Total",2614,1347,615,732,21,1107,929,178,131,123,0,6,2,8
"2011","Solihull 005","E02002085","Total",2593,1397,677,720,19,946,829,117,210,197,0,10,3,21
"2011","Solihull 006","E02002086","Total",2462,932,385,547,10,1357,1168,189,143,131,1,6,5,20
"2011","Solihull 007","E02002087","Total",2684,1260,535,725,17,1172,1108,64,218,192,3,20,3,17
"2011","Solihull 008","E02002088","Total",4116,1833,772,1061,38,1866,1606,260,353,327,0,23,3,26
"2011","Solihull 009","E02002089","Total",3084,2304,1059,1245,40,397,229,168,316,295,1,20,0,27
"2011","Solihull 010","E02002090","Total",2302,1989,892,1097,4,76,56,20,219,197,2,18,2,14
"2011","Solihull 011","E02002091","Total",3160,2578,1425,1153,4,206,146,60,347,313,3,30,1,25
"2011","Solihull 012","E02002092","Total",3058,2058,958,1100,19,672,612,60,280,254,0,25,1,29
"2011","Solihull 013","E02002093","Total",2836,1943,988,955,20,411,254,157,440,414,0,24,2,22
"2011","Solihull 014","E02002094","Total",2380,2106,1162,944,6,16,13,3,227,215,0,10,2,25
"2011","Solihull 015","E02002095","Total",3613,2726,1329,1397,51,338,249,89,477,431,3,37,6,21
"2011","Solihull 016","E02002096","Total",4165,3211,1839,1372,57,372,305,67,492,462,6,19,5,33
"2011","Solihull 017","E02002097","Total",2860,2142,1151,991,4,360,227,133,308,258,7,33,10,46
"2011","Solihull 018","E02002098","Total",3808,3007,1563,1444,3,475,347,128,300,278,1,17,4,23
"2011","Solihull 019","E02002099","Total",2687,2260,1349,911,6,74,14,60,321,298,6,13,4,26
"2011","Solihull 021","E02002101","Total",2645,2055,1067,988,17,263,183,80,286,258,3,23,2,24
"2011","Solihull 022","E02002102","Total",3474,2756,1420,1336,27,260,183,77,410,367,0,41,2,21
"2011","Solihull 023","E02002103","Total",2575,2185,1240,945,3,214,203,11,151,129,2,19,1,22
"2011","Solihull 024","E02002104","Total",2399,2139,1025,1114,4,21,12,9,225,213,1,11,0,10
"2011","Solihull 025","E02002105","Total",3101,2683,1380,1303,9,120,72,48,267,247,5,12,3,22
"2011","Solihull 026","E02002106","Total",3888,3266,1944,1322,9,222,123,99,359,325,6,19,9,32
"2011","Solihull 027","E02002107","Total",2269,1941,871,1070,30,47,42,5,240,231,1,7,1,11
"2011","Solihull 028","E02002108","Total",3867,3386,1818,1568,10,169,116,53,281,262,1,16,2,21
"2011","Solihull 029","E02002109","Total",3874,2984,1233,1751,30,83,53,30,743,697,6,36,4,34
"2011","Solihull 030","E02006808","Total",2393,2005,908,1097,3,89,82,7,283,257,3,21,2,13
"2011","Walsall 001","E02002110","Total",2689,1871,755,1116,46,458,226,232,283,247,8,27,1,31
"2011","Walsall 002","E02002111","Total",2484,1546,814,732,13,705,316,389,185,159,4,16,6,35
"2011","Walsall 003","E02002112","Total",2219,1679,815,864,6,395,204,191,116,99,0,15,2,23
"2011","Walsall 004","E02002113","Total",2683,1724,805,919,35,561,261,300,333,307,3,18,5,30
"2011","Walsall 005","E02002114","Total",2642,1973,1111,862,11,397,136,261,234,207,1,23,3,27
"2011","Walsall 006","E02002115","Total",2835,1682,918,764,5,918,482,436,180,162,1,9,8,50
"2011","Walsall 007","E02002116","Total",2849,2321,1222,1099,7,309,157,152,180,161,1,16,2,32
"2011","Walsall 008","E02002117","Total",2682,1610,745,865,4,776,285,491,247,217,2,22,6,45
"2011","Walsall 009","E02002118","Total",3019,1589,735,854,14,1097,527,570,274,251,1,16,6,45
"2011","Walsall 010","E02002119","Total",2451,1795,888,907,31,425,214,211,183,162,1,18,2,17
"2011","Walsall 011","E02002120","Total",2386,1840,771,1069,36,358,186,172,138,128,0,10,0,14
"2011","Walsall 012","E02002121","Total",2401,1123,498,625,13,887,465,422,341,317,2,15,7,37
"2011","Walsall 013","E02002122","Total",2006,899,394,505,15,768,510,258,296,276,1,7,12,28
"2011","Walsall 014","E02002123","Total",2694,1769,908,861,11,650,278,372,220,192,0,20,8,44
"2011","Walsall 015","E02002124","Total",3161,2142,1149,993,10,635,307,328,334,303,4,26,1,40
"2011","Walsall 016","E02002125","Total",2552,1685,795,890,37,566,228,338,224,201,3,16,4,40
"2011","Walsall 017","E02002126","Total",2656,989,440,549,3,1298,323,975,327,302,0,17,8,39
"2011","Walsall 018","E02002127","Total",3087,1239,508,731,26,1257,660,597,519,488,0,15,16,46
"2011","Walsall 019","E02002128","Total",2386,1659,915,744,8,506,274,232,191,176,1,13,1,22
"2011","Walsall 020","E02002129","Total",2451,1861,1048,813,0,347,174,173,213,190,1,20,2,30
"2011","Walsall 021","E02002130","Total",2540,1264,538,726,22,871,68,803,342,321,0,19,2,41
"2011","Walsall 022","E02002131","Total",3182,2822,1574,1248,3,157,66,91,179,154,2,20,3,21
"2011","Walsall 023","E02002132","Total",2559,1348,616,732,4,1003,538,465,165,142,0,19,4,39
"2011","Walsall 024","E02002133","Total",3041,1558,861,697,33,917,195,722,496,465,4,18,9,37
"2011","Walsall 025","E02002134","Total",3308,1758,765,993,51,915,467,448,543,517,0,18,8,41
"2011","Walsall 026","E02002135","Total",2585,1220,556,664,9,750,303,447,545,515,7,15,8,61
"2011","Walsall 027","E02002136","Total",3093,1726,685,1041,20,750,397,353,563,534,2,26,1,34
"2011","Walsall 028","E02002137","Total",2652,2415,1424,991,5,22,6,16,193,174,0,17,2,17
"2011","Walsall 029","E02002138","Total",2313,1747,923,824,11,102,8,94,427,397,1,24,5,26
"2011","Walsall 030","E02002139","Total",3905,1234,615,619,28,1715,361,1354,856,805,3,28,20,72
"2011","Walsall 031","E02002140","Total",2936,1452,757,695,6,872,333,539,552,496,1,49,6,54
"2011","Walsall 032","E02002141","Total",2666,2391,1185,1206,8,57,20,37,199,175,0,22,2,11
"2011","Walsall 033","E02002142","Total",2443,1247,574,673,6,772,263,509,383,352,1,25,5,35
"2011","Walsall 034","E02002143","Total",3150,1549,759,790,16,806,229,577,713,654,1,43,15,66
"2011","Walsall 035","E02002144","Total",2498,2256,1410,846,1,61,4,57,161,151,5,5,0,19
"2011","Walsall 036","E02002145","Total",2741,1298,521,777,12,1042,423,619,348,330,1,14,3,41
"2011","Walsall 037","E02002146","Total",2257,1413,638,775,6,499,196,303,302,275,2,21,4,37
"2011","Walsall 038","E02002147","Total",3081,1533,711,822,10,1184,632,552,295,263,1,28,3,59
"2011","Walsall 039","E02002148","Total",4539,4038,2170,1868,19,159,52,107,289,268,0,20,1,34
"2011","Wolverhampton 001","E02002149","Total",4268,2849,1453,1396,12,1005,857,148,332,299,3,25,5,70
"2011","Wolverhampton 002","E02002150","Total",2259,1465,643,822,18,520,484,36,213,199,0,14,0,43
"2011","Wolverhampton 003","E02002151","Total",2548,1172,365,807,39,1060,851,209,239,221,0,16,2,38
"2011","Wolverhampton 004","E02002152","Total",2337,1043,476,567,9,1095,1036,59,138,119,0,16,3,52
"2011","Wolverhampton 005","E02002153","Total",3384,2043,1063,980,2,1112,1044,68,171,141,0,24,6,56
"2011","Wolverhampton 006","E02002154","Total",2270,1312,589,723,4,617,406,211,289,271,0,15,3,48
"2011","Wolverhampton 007","E02002155","Total",2129,604,310,294,7,1284,1013,271,201,186,0,11,4,33
"2011","Wolverhampton 008","E02002156","Total",3409,2350,1113,1237,18,651,566,85,323,293,0,28,2,67
"2011","Wolverhampton 009","E02002157","Total",3170,2515,1262,1253,14,235,186,49,366,341,2,23,0,40
"2011","Wolverhampton 010","E02002158","Total",3437,2219,1222,997,3,976,904,72,168,142,0,24,2,71
"2011","Wolverhampton 011","E02002159","Total",2215,978,420,558,11,805,711,94,370,341,1,16,12,51
"2011","Wolverhampton 012","E02002160","Total",2762,1963,965,998,9,358,314,44,395,380,2,10,3,37
"2011","Wolverhampton 013","E02002161","Total",2426,1074,446,628,32,768,449,319,520,484,6,17,13,32
"2011","Wolverhampton 014","E02002162","Total",3275,2535,1550,985,22,360,317,43,299,267,4,24,4,59
"2011","Wolverhampton 015","E02002163","Total",5059,1610,743,867,26,2607,2088,519,702,630,17,31,24,114
"2011","Wolverhampton 016","E02002164","Total",2361,605,368,237,14,1096,559,537,587,546,3,22,16,59
"2011","Wolverhampton 017","E02002165","Total",3611,1494,708,786,6,626,275,351,1421,1383,3,23,12,64
"2011","Wolverhampton 018","E02002166","Total",3839,1763,850,913,4,1582,1431,151,410,380,0,23,7,80
"2011","Wolverhampton 019","E02002167","Total",2977,2163,1218,945,7,483,462,21,270,237,0,28,5,54
"2011","Wolverhampton 020","E02002168","Total",4422,1553,793,760,25,1434,748,686,1326,1270,11,33,12,84
"2011","Wolverhampton 021","E02002169","Total",3531,2933,1686,1247,6,223,186,37,334,308,3,22,1,35
"2011","Wolverhampton 022","E02002170","Total",2461,1512,760,752,8,670,540,130,230,217,1,11,1,41
"2011","Wolverhampton 023","E02002171","Total",3059,1681,884,797,12,1023,939,84,279,255,1,22,1,64
"2011","Wolverhampton 026","E02002174","Total",2975,2278,1113,1165,3,225,105,120,440,422,2,14,2,29
"2011","Wolverhampton 027","E02002175","Total",2901,1219,627,592,11,1210,902,308,392,370,1,17,4,69
"2011","Wolverhampton 028","E02002176","Total",3338,2070,999,1071,7,981,887,94,232,205,0,25,2,48
"2011","Wolverhampton 029","E02002177","Total",3821,1638,723,915,22,1541,1270,271,545,510,1,26,8,75
"2011","Wolverhampton 030","E02002178","Total",2722,2239,1272,967,6,95,79,16,353,334,2,16,1,29
"2011","Wolverhampton 031","E02002179","Total",2580,2116,1134,982,5,164,109,55,250,231,1,16,2,45
"2011","Wolverhampton 032","E02002180","Total",2666,1847,1065,782,7,552,532,20,221,201,2,16,2,39
"2011","Wolverhampton 033","E02002181","Total",2979,1342,636,706,13,1293,1180,113,261,244,0,12,5,70
"2011","Wolverhampton 034","E02002182","Total",2515,1574,766,808,6,684,596,88,201,187,2,11,1,50
"2011","Wolverhampton 035","E02006894","Total",4471,2053,1194,859,31,1313,770,543,977,903,11,35,28,97
"2011","Bromsgrove 001","E02006696","Total",2504,2194,1248,946,6,52,16,36,223,210,2,8,3,29
"2011","Bromsgrove 002","E02006697","Total",3030,2460,1422,1038,13,193,65,128,303,262,8,28,5,61
"2011","Bromsgrove 003","E02006698","Total",2674,2269,1199,1070,27,161,36,125,194,177,3,14,0,23
"2011","Bromsgrove 004","E02006699","Total",2569,2066,1155,911,7,341,113,228,133,112,1,20,0,22
"2011","Bromsgrove 005","E02006700","Total",2308,2097,1150,947,12,38,18,20,136,115,4,16,1,25
"2011","Bromsgrove 006","E02006701","Total",2383,2169,1173,996,4,14,5,9,174,156,3,12,3,22
"2011","Bromsgrove 007","E02006702","Total",2427,1700,805,895,40,472,135,337,188,162,1,24,1,27
"2011","Bromsgrove 008","E02006703","Total",2891,2560,1254,1306,6,102,28,74,199,184,4,11,0,24
"2011","Bromsgrove 009","E02006704","Total",2717,2195,1197,998,16,223,78,145,244,210,6,18,10,39
"2011","Bromsgrove 010","E02006705","Total",2819,2044,933,1111,3,440,133,307,305,277,4,23,1,27
"2011","Bromsgrove 011","E02006706","Total",3062,2085,1128,957,20,543,111,432,380,341,11,24,4,34
"2011","Bromsgrove 012","E02006707","Total",2638,2383,1084,1299,9,56,15,41,179,171,1,6,1,11
"2011","Bromsgrove 013","E02006708","Total",3418,1919,718,1201,63,1010,344,666,387,357,6,18,6,39
"2011","Bromsgrove 014","E02006709","Total",2850,2295,1088,1207,22,174,42,132,325,301,4,15,5,34
"2011","Malvern Hills 001","E02006710","Total",3402,2422,1524,898,21,418,18,400,462,415,5,36,6,79
"2011","Malvern Hills 002","E02006711","Total",3235,2512,1529,983,20,311,40,271,324,283,11,22,8,68
"2011","Malvern Hills 003","E02006712","Total",2842,2325,1330,995,27,185,26,159,272,231,8,28,5,33
"2011","Malvern Hills 004","E02006713","Total",2881,1935,1164,771,32,474,61,413,404,369,2,27,6,36
"2011","Malvern Hills 005","E02006714","Total",2293,1740,1052,688,8,199,23,176,290,252,10,17,11,56
"2011","Malvern Hills 006","E02006715","Total",3455,2548,1291,1257,45,457,68,389,377,346,2,28,1,28
"2011","Malvern Hills 007","E02006716","Total",2740,1254,660,594,39,1263,182,1081,151,130,1,18,2,33
"2011","Malvern Hills 008","E02006717","Total",2426,1950,1110,840,10,236,32,204,190,172,5,13,0,40
"2011","Malvern Hills 009","E02006718","Total",2730,1952,1273,679,36,451,50,401,257,233,4,15,5,34
"2011","Malvern Hills 010","E02006719","Total",3229,2376,1440,936,9,145,3,142,641,598,10,28,5,58
"2011","Malvern Hills 011","E02006720","Total",2979,2132,1307,825,16,408,55,353,352,310,9,31,2,71
"2011","Redditch 001","E02006721","Total",2401,2078,994,1084,8,182,104,78,120,110,0,10,0,13
"2011","Redditch 002","E02006722","Total",2312,1069,280,789,3,941,784,157,270,236,2,28,4,29
"2011","Redditch 003","E02006723","Total",3441,1797,524,1273,3,1294,1042,252,292,267,2,21,2,55
"2011","Redditch 004","E02006724","Total",2742,1129,377,752,27,877,659,218,663,628,1,24,10,46
"2011","Redditch 005","E02006725","Total",2411,1437,524,913,4,739,624,115,205,176,2,26,1,26
"2011","Redditch 006","E02006726","Total",2594,1673,688,985,7,383,295,88,505,468,7,29,1,26
"2011","Redditch 007","E02006727","Total",2475,1996,894,1102,17,212,101,111,225,204,0,18,3,25
"2011","Redditch 008","E02006728","Total",2961,2353,1103,1250,8,263,179,84,310,266,2,41,1,27
"2011","Redditch 009","E02006729","Total",2831,2125,800,1325,6,442,412,30,231,202,4,25,0,27
"2011","Redditch 010","E02006730","Total",2391,1140,390,750,25,873,748,125,320,294,5,21,0,33
"2011","Redditch 011","E02006731","Total",2597,1611,668,943,8,678,404,274,273,254,2,15,2,27
"2011","Redditch 012","E02006732","Total",3007,2468,1075,1393,7,203,175,28,307,288,1,17,1,22
"2011","Redditch 013","E02006733","Total",2559,1920,887,1033,11,264,176,88,338,307,3,24,4,26
"2011","Worcester 001","E02006734","Total",3494,2935,1510,1425,20,129,34,95,385,358,1,23,3,25
"2011","Worcester 002","E02006735","Total",2379,837,349,488,21,1315,608,707,157,130,0,19,8,49
"2011","Worcester 003","E02006736","Total",2829,2099,564,1535,5,140,9,131,570,527,1,35,7,15
"2011","Worcester 004","E02006737","Total",3464,2430,1126,1304,40,398,108,290,567,506,4,51,6,29
"2011","Worcester 005","E02006738","Total",3649,1668,706,962,97,1320,623,697,512,474,1,31,6,52
"2011","Worcester 006","E02006739","Total",2106,1606,938,668,3,102,32,70,382,349,1,29,3,13
"2011","Worcester 007","E02006740","Total",3554,1632,729,903,20,415,78,337,1429,1365,4,43,17,58
"2011","Worcester 008","E02006741","Total",2151,1647,475,1172,5,90,5,85,397,380,1,16,0,12
"2011","Worcester 009","E02006742","Total",3544,1883,919,964,39,924,330,594,646,597,3,35,11,52
"2011","Worcester 010","E02006743","Total",2579,1621,700,921,48,596,279,317,294,263,2,25,4,20
"2011","Worcester 011","E02006744","Total",3262,1552,677,875,34,545,122,423,1089,1029,10,43,7,42
"2011","Worcester 012","E02006745","Total",3252,2714,1437,1277,12,164,64,100,333,299,4,26,4,29
"2011","Worcester 013","E02006746","Total",3297,2427,1236,1191,69,245,61,184,522,477,8,33,4,34
"2011","Worcester 014","E02006747","Total",2482,2026,815,1211,23,55,3,52,362,339,0,23,0,16
"2011","Wychavon 001","E02006748","Total",2765,2141,1147,994,8,301,25,276,268,236,10,15,7,47
"2011","Wychavon 002","E02006749","Total",2185,1170,429,741,4,790,99,691,212,181,0,29,2,9
"2011","Wychavon 003","E02006750","Total",2587,1679,937,742,27,499,47,452,353,322,5,24,2,29
"2011","Wychavon 004","E02006751","Total",2561,1659,883,776,7,649,78,571,203,178,4,15,6,43
"2011","Wychavon 005","E02006752","Total",2730,2427,1149,1278,6,143,10,133,143,130,1,8,4,11
"2011","Wychavon 006","E02006753","Total",2595,2097,1199,898,7,223,32,191,236,215,6,13,2,32
"2011","Wychavon 007","E02006754","Total",2243,1802,1030,772,7,140,17,123,245,217,7,16,5,49
"2011","Wychavon 008","E02006755","Total",2212,1888,1107,781,8,99,10,89,183,161,8,13,1,34
"2011","Wychavon 009","E02006756","Total",2085,1715,741,974,4,143,10,133,198,176,1,16,5,25
"2011","Wychavon 010","E02006757","Total",2854,2240,1333,907,3,295,25,270,258,219,10,19,10,58
"2011","Wychavon 011","E02006758","Total",2134,1621,773,848,4,318,35,283,152,131,7,11,3,39
"2011","Wychavon 012","E02006759","Total",3285,2137,1329,808,37,657,54,603,403,357,15,28,3,51
"2011","Wychavon 013","E02006760","Total",3293,2429,1334,1095,16,517,66,451,285,240,7,30,8,46
"2011","Wychavon 014","E02006761","Total",2776,1219,571,648,23,744,78,666,749,703,17,22,7,41
"2011","Wychavon 015","E02006762","Total",2422,1860,966,894,7,224,21,203,315,293,0,21,1,16
"2011","Wychavon 016","E02006763","Total",2619,2099,1032,1067,29,215,23,192,248,221,2,22,3,28
"2011","Wychavon 017","E02006764","Total",2210,1330,531,799,8,555,79,476,292,269,6,16,1,25
"2011","Wychavon 018","E02006765","Total",2696,1968,1219,749,14,361,45,316,309,268,17,15,9,44
"2011","Wychavon 019","E02006766","Total",3214,2492,1448,1044,6,293,17,276,367,326,15,19,7,56
"2011","Wyre Forest 001","E02006767","Total",3804,2787,1642,1145,13,547,210,337,395,349,9,26,11,62
"2011","Wyre Forest 002","E02006768","Total",2910,2337,1262,1075,9,244,93,151,294,262,0,29,3,26
"2011","Wyre Forest 003","E02006769","Total",3047,2537,1224,1313,5,51,2,49,431,396,8,26,1,23
"2011","Wyre Forest 004","E02006770","Total",3196,1487,586,901,13,900,515,385,750,702,6,40,2,46
"2011","Wyre Forest 005","E02006771","Total",2933,2168,1319,849,12,355,149,206,341,296,4,37,4,57
"2011","Wyre Forest 006","E02006772","Total",2815,2037,1115,922,3,511,232,279,231,203,2,24,2,33
"2011","Wyre Forest 007","E02006773","Total",3790,2416,1307,1109,38,749,368,381,539,497,8,33,1,48
"2011","Wyre Forest 008","E02006774","Total",3347,2210,1016,1194,27,392,147,245,682,653,0,25,4,36
"2011","Wyre Forest 009","E02006775","Total",2070,906,394,512,15,917,519,398,198,170,3,19,6,34
"2011","Wyre Forest 010","E02006776","Total",2817,2154,1014,1140,27,290,77,213,333,294,0,39,0,13
"2011","Wyre Forest 011","E02006777","Total",3248,2613,1641,972,16,180,64,116,392,349,1,38,4,47
"2011","Wyre Forest 012","E02006778","Total",2894,2397,1325,1072,19,240,98,142,215,191,1,22,1,23
"2011","Wyre Forest 013","E02006779","Total",3497,2431,1216,1215,46,305,125,180,691,651,3,30,7,24
"2011","Wyre Forest 014","E02006780","Total",2617,1880,1135,745,16,524,286,238,168,142,1,21,4,29
"2011","Bedford 001","E02003616","Total",2275,1807,987,820,15,187,8,179,222,179,10,20,13,44
"2011","Bedford 002","E02003617","Total",3714,2882,1542,1340,40,303,16,287,417,371,11,23,12,72
"2011","Bedford 003","E02003618","Total",3521,2759,1356,1403,46,317,44,273,371,328,1,33,9,28
"2011","Bedford 004","E02003619","Total",4057,3083,1478,1605,78,457,43,414,379,344,9,19,7,60
"2011","Bedford 005","E02003620","Total",3497,2670,1505,1165,13,504,50,454,277,243,2,25,7,33
"2011","Bedford 006","E02003621","Total",3304,2787,1627,1160,8,305,22,283,191,160,1,28,2,13
"2011","Bedford 007","E02003622","Total",3762,2147,996,1151,35,1162,170,992,363,335,1,25,2,55
"2011","Bedford 008","E02003623","Total",3285,2793,1410,1383,43,179,7,172,241,221,6,11,3,29
"2011","Bedford 009","E02003624","Total",2346,1337,701,636,11,206,22,184,746,704,4,31,7,46
"2011","Bedford 010","E02003625","Total",3737,1546,670,876,16,888,90,798,1247,1174,5,54,14,40
"2011","Bedford 011","E02003626","Total",2259,1632,723,909,13,219,23,196,379,348,4,24,3,16
"2011","Bedford 012","E02003627","Total",4080,1813,832,981,36,690,74,616,1485,1424,4,33,24,56
"2011","Bedford 013","E02003628","Total",2801,1545,711,834,31,445,64,381,730,686,4,31,9,50
"2011","Bedford 014","E02003629","Total",3940,2041,786,1255,30,1165,189,976,654,614,5,30,5,50
"2011","Bedford 015","E02003630","Total",3681,1730,717,1013,61,929,137,792,910,836,25,29,20,51
"2011","Bedford 016","E02003631","Total",2180,1318,581,737,26,588,31,557,233,210,3,13,7,15
"2011","Bedford 017","E02003632","Total",2491,1701,747,954,39,275,32,243,445,408,5,28,4,31
"2011","Bedford 018","E02003633","Total",2982,2045,908,1137,16,585,64,521,312,272,6,26,8,24
"2011","Bedford 019","E02003634","Total",3747,2612,1005,1607,98,634,49,585,367,334,4,19,10,36
"2011","Bedford 020","E02003635","Total",2153,1689,736,953,10,214,20,194,141,119,4,12,6,99
"2011","Central Bedfordshire 001","E02003599","Total",2236,1494,454,1040,38,457,44,413,225,214,0,11,0,22
"2011","Central Bedfordshire 002","E02003600","Total",2556,1793,760,1033,18,398,53,345,307,291,2,11,3,40
"2011","Central Bedfordshire 003","E02003601","Total",3029,2217,1015,1202,19,372,59,313,382,355,4,17,6,39
"2011","Central Bedfordshire 004","E02003602","Total",2444,1699,912,787,4,377,33,344,328,296,11,12,9,36
"2011","Central Bedfordshire 005","E02003603","Total",4186,2794,1154,1640,42,586,54,532,714,672,2,32,8,50
"2011","Central Bedfordshire 006","E02003604","Total",2729,1969,830,1139,36,486,44,442,203,187,3,13,0,35
"2011","Central Bedfordshire 007","E02003605","Total",3066,2175,1079,1096,11,311,18,293,529,409,21,18,81,40
"2011","Central Bedfordshire 008","E02003606","Total",3068,2376,1163,1213,18,400,28,372,231,201,7,18,5,43
"2011","Central Bedfordshire 009","E02003607","Total",3499,2379,971,1408,31,435,21,414,563,493,25,23,22,91
"2011","Central Bedfordshire 010","E02003608","Total",4562,3309,1255,2054,49,731,56,675,440,392,9,33,6,33
"2011","Central Bedfordshire 011","E02003609","Total",4001,2639,1124,1515,44,673,29,644,597,361,112,34,90,48
"2011","Central Bedfordshire 012","E02003610","Total",2966,2300,1115,1185,3,288,25,263,343,292,5,34,12,32
"2011","Central Bedfordshire 013","E02003611","Total",3353,2487,1177,1310,38,326,14,312,482,220,156,17,89,20
"2011","Central Bedfordshire 014","E02003612","Total",3978,3077,1171,1906,52,414,41,373,388,359,1,25,3,47
"2011","Central Bedfordshire 015","E02003613","Total",2387,1594,665,929,9,469,25,444,287,268,1,16,2,28
"2011","Central Bedfordshire 016","E02003614","Total",3020,2477,973,1504,22,101,9,92,395,348,10,31,6,25
"2011","Central Bedfordshire 017","E02003615","Total",3451,2808,1320,1488,29,303,14,289,268,239,6,16,7,43
"2011","Central Bedfordshire 018","E02003636","Total",2974,2407,1036,1371,23,195,141,54,329,299,4,23,3,20
"2011","Central Bedfordshire 019","E02003637","Total",3878,3042,1448,1594,24,393,351,42,364,328,9,24,3,55
"2011","Central Bedfordshire 020","E02003638","Total",2933,2475,1144,1331,8,232,219,13,198,177,5,14,2,20
"2011","Central Bedfordshire 021","E02003639","Total",3948,2248,932,1316,35,940,708,232,648,578,3,61,6,77
"2011","Central Bedfordshire 022","E02003640","Total",2621,1933,944,989,14,230,155,75,414,384,5,22,3,30
"2011","Central Bedfordshire 023","E02003641","Total",2233,1896,777,1119,5,70,38,32,246,221,2,21,2,16
"2011","Central Bedfordshire 025","E02003642","Total",3325,1888,583,1305,38,977,878,99,392,362,2,25,3,30
"2011","Central Bedfordshire 024","E02003643","Total",3946,2895,913,1982,78,415,124,291,535,483,11,29,12,23
"2011","Central Bedfordshire 026","E02003644","Total",3473,2333,855,1478,30,671,248,423,404,355,2,36,11,35
"2011","Central Bedfordshire 027","E02003645","Total",2648,2272,1114,1158,25,79,11,68,261,229,7,22,3,11
"2011","Central Bedfordshire 028","E02003646","Total",3557,2425,1052,1373,37,745,599,146,302,268,2,30,2,48
"2011","Central Bedfordshire 029","E02003647","Total",3862,2407,1044,1363,26,556,322,234,825,773,5,39,8,48
"2011","Central Bedfordshire 030","E02003648","Total",2206,1290,565,725,14,694,557,137,179,168,0,7,4,29
"2011","Central Bedfordshire 031","E02003649","Total",2786,2263,1108,1155,32,111,68,43,366,351,3,10,2,14
"2011","Central Bedfordshire 032","E02003650","Total",2914,2302,1261,1041,14,346,330,16,216,178,14,18,6,36
"2011","Central Bedfordshire 033","E02003651","Total",2564,2080,1125,955,8,200,148,52,251,222,10,14,5,25
"2011","Luton 001","E02003258","Total",3462,2926,1220,1706,8,100,65,35,408,374,1,29,4,20
"2011","Luton 002","E02003259","Total",2542,1877,875,1002,6,368,232,136,275,243,1,27,4,16
"2011","Luton 003","E02003260","Total",3194,1434,432,1002,23,1293,1115,178,406,366,0,35,5,38
"2011","Luton 004","E02003261","Total",2470,1881,1002,879,3,330,266,64,228,196,2,30,0,28
"2011","Luton 005","E02003262","Total",3872,2140,875,1265,14,1214,873,341,465,438,0,22,5,39
"2011","Luton 006","E02003263","Total",4325,3020,1375,1645,19,421,342,79,829,770,5,50,4,36
"2011","Luton 007","E02003264","Total",3226,2829,1214,1615,10,45,7,38,332,312,5,12,3,10
"2011","Luton 008","E02003265","Total",3458,2638,1206,1432,9,341,236,105,434,386,4,39,5,36
"2011","Luton 009","E02003266","Total",3618,1872,579,1293,15,1260,1054,206,424,393,0,26,5,47
"2011","Luton 010","E02003267","Total",3584,2335,854,1481,17,241,116,125,962,896,0,55,11,29
"2011","Luton 011","E02003268","Total",3487,2238,905,1333,19,399,56,343,802,740,3,49,10,29
"2011","Luton 012","E02003269","Total",4040,2863,1299,1564,16,256,172,84,863,816,9,30,8,42
"2011","Luton 013","E02003270","Total",3137,2215,1183,1032,16,269,107,162,595,522,6,39,28,42
"2011","Luton 014","E02003271","Total",3954,2930,999,1931,7,294,137,157,699,662,0,36,1,24
"2011","Luton 015","E02003272","Total",2643,1688,699,989,14,221,89,132,677,621,5,33,18,43
"2011","Luton 016","E02003273","Total",3789,2416,943,1473,10,834,705,129,494,456,4,27,7,35
"2011","Luton 017","E02003274","Total",3128,1237,500,737,17,508,170,338,1301,1236,4,42,19,65
"2011","Luton 018","E02003275","Total",5297,1458,596,862,22,1093,765,328,2666,2587,8,39,32,58
"2011","Luton 019","E02003276","Total",2511,1207,486,721,12,279,73,206,977,940,2,23,12,36
"2011","Luton 020","E02003277","Total",3720,1768,667,1101,10,1169,1036,133,708,665,2,31,10,65
"2011","Luton 021","E02003278","Total",4836,1724,710,1014,21,780,357,423,2271,2183,9,52,27,40
"2011","Peterborough 001","E02003237","Total",2600,2133,1042,1091,20,165,52,113,259,234,3,18,4,23
"2011","Peterborough 002","E02003238","Total",2466,1613,493,1120,44,399,96,303,387,361,1,24,1,23
"2011","Peterborough 003","E02003239","Total",3275,2776,1270,1506,13,147,66,81,318,286,4,25,3,21
"2011","Peterborough 004","E02003240","Total",2480,1521,713,808,11,238,62,176,662,329,187,8,138,48
"2011","Peterborough 005","E02003241","Total",2567,1814,822,992,26,337,115,222,345,313,7,22,3,45
"2011","Peterborough 006","E02003242","Total",3584,2651,1442,1209,11,471,147,324,421,373,4,44,0,30
"2011","Peterborough 007","E02003243","Total",4071,1574,529,1045,37,1920,812,1108,492,452,1,22,17,48
"2011","Peterborough 008","E02003244","Total",3685,1776,788,988,32,1405,554,851,409,375,3,20,11,63
"2011","Peterborough 009","E02003245","Total",2967,1168,420,748,20,1199,473,726,553,515,5,24,9,27
"2011","Peterborough 010","E02003246","Total",3094,1545,608,937,19,538,201,337,962,894,7,46,15,30
"2011","Peterborough 011","E02003247","Total",3272,1782,754,1028,12,932,255,677,516,475,2,34,5,30
"2011","Peterborough 012","E02003248","Total",3284,2064,970,1094,24,291,50,241,863,798,3,48,14,42
"2011","Peterborough 013","E02003249","Total",4368,2129,1000,1129,40,1222,428,794,933,883,1,35,14,44
"2011","Peterborough 014","E02003250","Total",3835,1549,776,773,33,563,134,429,1623,1522,27,54,20,67
"2011","Peterborough 015","E02003251","Total",2852,2409,1457,952,3,136,21,115,276,249,6,13,8,28
"2011","Peterborough 016","E02003252","Total",4163,2328,783,1545,26,523,159,364,1239,1143,12,64,20,47
"2011","Peterborough 017","E02003253","Total",3841,2059,841,1218,29,727,221,506,978,926,7,38,7,48
"2011","Peterborough 018","E02003254","Total",3732,2908,1436,1472,30,272,64,208,449,417,4,23,5,73
"2011","Peterborough 019","E02003255","Total",3777,2722,1318,1404,15,585,202,383,417,362,1,46,8,38
"2011","Peterborough 021","E02003257","Total",3532,1544,506,1038,13,1254,404,850,680,634,1,28,17,41
"2011","Peterborough 022","E02006877","Total",3205,2016,810,1206,76,513,98,415,576,541,1,32,2,24
"2011","Peterborough 023","E02006878","Total",3373,1796,356,1440,155,597,137,460,810,773,1,31,5,15
"2011","Southend-on-Sea 001","E02003279","Total",3982,3435,1891,1544,9,141,73,68,373,330,1,40,2,24
"2011","Southend-on-Sea 002","E02003280","Total",4205,3162,1527,1635,13,559,464,95,428,388,1,37,2,43
"2011","Southend-on-Sea 003","E02003281","Total",4173,3250,1786,1464,8,440,366,74,437,401,5,25,6,38
"2011","Southend-on-Sea 004","E02003282","Total",4208,3076,1531,1545,11,405,236,169,686,630,8,43,5,30
"2011","Southend-on-Sea 005","E02003283","Total",4279,2986,1401,1585,12,764,607,157,471,424,1,41,5,46
"2011","Southend-on-Sea 006","E02003284","Total",4646,3071,1259,1812,23,487,386,101,1027,960,3,61,3,38
"2011","Southend-on-Sea 007","E02003285","Total",4386,2780,912,1868,14,66,17,49,1498,1419,6,65,8,28
"2011","Southend-on-Sea 008","E02003286","Total",3840,3234,1652,1582,10,61,43,18,509,481,0,28,0,26
"2011","Southend-on-Sea 009","E02003287","Total",4065,2754,1543,1211,27,793,470,323,451,424,2,19,6,40
"2011","Southend-on-Sea 010","E02003288","Total",4965,1969,760,1209,20,1453,946,507,1469,1367,41,39,22,54
"2011","Southend-on-Sea 011","E02003289","Total",4608,3233,1335,1898,11,44,24,20,1288,1214,5,62,7,32
"2011","Southend-on-Sea 012","E02003290","Total",4369,2717,1238,1479,9,189,92,97,1408,1351,3,46,8,46
"2011","Southend-on-Sea 013","E02003291","Total",4782,2721,1104,1617,42,1106,520,586,874,812,3,52,7,39
"2011","Southend-on-Sea 014","E02003292","Total",5087,1813,622,1191,55,1230,265,965,1951,1889,7,40,15,38
"2011","Southend-on-Sea 015","E02003293","Total",5199,2347,1057,1290,21,144,33,111,2615,2511,11,82,11,72
"2011","Southend-on-Sea 016","E02003294","Total",3921,3338,1951,1387,8,28,12,16,507,461,3,38,5,40
"2011","Southend-on-Sea 017","E02003295","Total",3963,2780,1391,1389,13,687,525,162,447,410,0,36,1,36
"2011","Thurrock 001","E02003296","Total",2743,2507,1295,1212,3,30,22,8,182,162,3,16,1,21
"2011","Thurrock 002","E02003297","Total",2895,2059,1035,1024,2,556,495,61,251,229,2,20,0,27
"2011","Thurrock 003","E02003298","Total",2838,2143,1066,1077,5,475,307,168,191,170,6,14,1,24
"2011","Thurrock 004","E02003299","Total",2370,1988,863,1125,8,131,130,1,217,184,9,17,7,26
"2011","Thurrock 005","E02003300","Total",3162,2459,1079,1380,2,203,133,70,471,440,1,27,3,27
"2011","Thurrock 006","E02003301","Total",3827,2523,974,1549,17,923,832,91,334,305,1,24,4,30
"2011","Thurrock 007","E02003302","Total",4082,2141,682,1459,9,1578,1475,103,321,300,2,17,2,33
"2011","Thurrock 008","E02003303","Total",3126,2078,810,1268,5,754,716,38,250,221,0,26,3,39
"2011","Thurrock 009","E02003304","Total",3599,2413,1110,1303,3,957,928,29,200,180,4,16,0,26
"2011","Thurrock 010","E02003305","Total",2319,1894,1007,887,4,268,259,9,126,117,1,6,2,27
"2011","Thurrock 012","E02003307","Total",3935,2258,1033,1225,4,1459,1372,87,192,174,1,15,2,22
"2011","Thurrock 013","E02003308","Total",2447,1855,671,1184,13,169,96,73,390,358,6,22,4,20
"2011","Thurrock 014","E02003309","Total",2999,2431,1083,1348,15,222,195,27,314,294,1,17,2,17
"2011","Thurrock 015","E02003310","Total",4783,2504,537,1967,101,792,630,162,1350,1288,4,50,8,36
"2011","Thurrock 016","E02003311","Total",3320,2089,739,1350,17,275,223,52,917,862,4,44,7,22
"2011","Thurrock 017","E02003312","Total",3466,1387,349,1038,43,785,555,230,1227,1183,2,38,4,24
"2011","Thurrock 018","E02003313","Total",4921,2316,811,1505,27,1831,1645,186,702,657,1,40,4,45
"2011","Thurrock 019","E02006859","Total",2680,1939,268,1671,8,25,18,7,695,674,1,18,2,13
"2011","Thurrock 020","E02006926","Total",2841,2294,487,1807,16,70,24,46,442,422,2,16,2,19
"2011","Cambridge 001","E02003719","Total",3918,1552,617,935,135,1535,1293,242,646,567,19,24,36,50
"2011","Cambridge 002","E02003720","Total",3886,1828,1045,783,34,1114,1051,63,846,786,10,37,13,64
"2011","Cambridge 003","E02003721","Total",4038,1556,769,787,90,1456,473,983,895,853,4,31,7,41
"2011","Cambridge 004","E02003722","Total",3729,1986,1102,884,10,473,126,347,1216,1164,10,25,17,44
"2011","Cambridge 005","E02003723","Total",2082,1175,718,457,5,246,95,151,619,499,18,27,75,37
"2011","Cambridge 006","E02003724","Total",4106,1704,719,985,28,1447,1145,302,861,816,3,38,4,66
"2011","Cambridge 007","E02003725","Total",3372,1544,1103,441,23,364,107,257,1336,1020,132,28,156,105
"2011","Cambridge 008","E02003726","Total",3366,1430,725,705,17,531,282,249,1344,1261,13,31,39,44
"2011","Cambridge 009","E02003727","Total",3857,1825,781,1044,30,538,360,178,1426,1358,8,43,17,38
"2011","Cambridge 010","E02003728","Total",3788,1753,848,905,24,915,745,170,1049,1004,5,31,9,47
"2011","Cambridge 011","E02003729","Total",3676,2142,1067,1075,14,928,739,189,548,506,3,35,4,44
"2011","Cambridge 012","E02003730","Total",3472,1627,931,696,97,749,346,403,906,836,27,21,22,93
"2011","Cambridge 013","E02003731","Total",3424,2049,1214,835,19,727,347,380,566,500,29,23,14,63
"2011","East Cambridgeshire 001","E02003732","Total",3584,2166,939,1227,53,723,75,648,573,514,14,35,10,69
"2011","East Cambridgeshire 002","E02003733","Total",3414,2647,1223,1424,30,411,33,378,274,237,6,26,5,52
"2011","East Cambridgeshire 003","E02003734","Total",4897,3195,1478,1717,123,782,71,711,721,664,11,32,14,76
"2011","East Cambridgeshire 004","E02003735","Total",3642,2257,993,1264,66,472,35,437,765,713,13,35,4,82
"2011","East Cambridgeshire 005","E02003736","Total",4024,3116,1519,1597,39,445,47,398,359,320,4,32,3,65
"2011","East Cambridgeshire 006","E02003737","Total",4782,3131,1296,1835,103,755,85,670,728,674,8,45,1,65
"2011","East Cambridgeshire 007","E02003738","Total",2534,1725,826,899,20,359,30,329,366,319,11,24,12,64
"2011","East Cambridgeshire 008","E02003739","Total",2631,2054,988,1066,20,306,34,272,207,193,2,11,1,44
"2011","East Cambridgeshire 009","E02003740","Total",2393,1643,923,720,23,377,31,346,287,248,14,19,6,63
"2011","East Cambridgeshire 011","E02006825","Total",2713,1785,960,825,29,314,16,298,296,262,17,14,3,289
"2011","Fenland 001","E02003742","Total",2775,2201,1286,915,23,254,40,214,264,234,3,22,5,33
"2011","Fenland 002","E02003743","Total",4066,2253,1140,1113,25,870,214,656,860,798,5,52,5,58
"2011","Fenland 003","E02003744","Total",5517,3265,1736,1529,21,1078,189,889,1074,1000,11,45,18,79
"2011","Fenland 004","E02003745","Total",4050,3015,1539,1476,32,483,96,387,442,385,8,42,7,78
"2011","Fenland 005","E02003746","Total",3066,2293,1175,1118,23,237,25,212,480,433,7,35,5,33
"2011","Fenland 006","E02003747","Total",4861,3511,1732,1779,14,542,80,462,739,674,4,58,3,55
"2011","Fenland 007","E02003748","Total",3444,2137,1159,978,12,573,82,491,672,637,2,24,9,50
"2011","Fenland 008","E02003749","Total",2509,2024,916,1108,4,127,26,101,308,278,1,23,6,46
"2011","Fenland 009","E02003750","Total",3068,2262,1292,970,20,264,36,228,471,436,2,30,3,51
"2011","Fenland 010","E02003751","Total",2727,2233,1076,1157,5,176,42,134,264,229,10,25,0,49
"2011","Fenland 011","E02003752","Total",4537,3242,1439,1803,26,450,65,385,767,698,2,58,9,52
"2011","Huntingdonshire 001","E02003753","Total",4448,3292,1313,1979,47,576,152,424,498,440,5,45,8,35
"2011","Huntingdonshire 002","E02003754","Total",2381,1768,885,883,2,232,51,181,341,310,8,16,7,38
"2011","Huntingdonshire 003","E02003755","Total",3559,2399,1104,1295,6,526,132,394,566,512,5,43,6,62
"2011","Huntingdonshire 004","E02003756","Total",2641,1992,855,1137,5,269,50,219,350,314,4,29,3,25
"2011","Huntingdonshire 005","E02003757","Total",2553,1913,839,1074,9,322,61,261,284,258,3,20,3,25
"2011","Huntingdonshire 006","E02003758","Total",3775,2751,1160,1591,33,338,67,271,614,441,95,23,55,39
"2011","Huntingdonshire 007","E02003759","Total",2414,2045,930,1115,6,163,29,134,184,163,3,17,1,16
"2011","Huntingdonshire 008","E02003760","Total",3081,1434,432,1002,46,1176,315,861,393,363,2,20,8,32
"2011","Huntingdonshire 009","E02003761","Total",2386,1846,865,981,13,278,63,215,230,212,2,15,1,19
"2011","Huntingdonshire 010","E02003762","Total",3431,2479,1228,1251,12,329,53,276,552,376,81,30,65,59
"2011","Huntingdonshire 011","E02003763","Total",4072,3071,1248,1823,46,322,54,268,616,567,2,46,1,17
"2011","Huntingdonshire 012","E02003764","Total",3929,2273,797,1476,78,520,44,476,1030,929,46,36,19,28
"2011","Huntingdonshire 013","E02003765","Total",2938,1916,1060,856,10,427,63,364,549,510,9,20,10,36
"2011","Huntingdonshire 014","E02003766","Total",2879,1926,818,1108,28,467,68,399,422,396,1,19,6,36
"2011","Huntingdonshire 015","E02003767","Total",2591,1973,962,1011,2,215,44,171,349,312,12,19,6,52
"2011","Huntingdonshire 016","E02003768","Total",3974,3192,1786,1406,12,272,44,228,462,426,5,26,5,36
"2011","Huntingdonshire 017","E02003769","Total",2657,2087,1036,1051,12,230,32,198,311,284,3,18,6,17
"2011","Huntingdonshire 018","E02003770","Total",3202,2395,1124,1271,73,394,57,337,301,269,12,20,0,39
"2011","Huntingdonshire 019","E02003771","Total",2785,1818,890,928,6,432,87,345,487,451,5,24,7,42
"2011","Huntingdonshire 020","E02003772","Total",2856,2345,1097,1248,1,121,10,111,374,335,1,34,4,15
"2011","Huntingdonshire 021","E02003773","Total",4334,2873,1064,1809,52,779,204,575,598,544,4,44,6,32
"2011","Huntingdonshire 022","E02003774","Total",2447,1610,678,932,9,551,131,420,259,224,3,29,3,18
"2011","South Cambridgeshire 001","E02003775","Total",2750,2127,961,1166,46,324,227,97,223,200,3,19,1,30
"2011","South Cambridgeshire 002","E02003776","Total",2658,1978,982,996,41,316,259,57,296,270,2,18,6,27
"2011","South Cambridgeshire 003","E02003777","Total",2715,2039,868,1171,36,260,188,72,339,315,6,16,2,41
"2011","South Cambridgeshire 004","E02003778","Total",2290,1418,719,699,22,332,237,95,472,231,138,11,92,46
"2011","South Cambridgeshire 005","E02003779","Total",2139,1707,804,903,20,113,51,62,272,255,1,15,1,27
"2011","South Cambridgeshire 006","E02003780","Total",4211,2659,1367,1292,173,816,361,455,523,482,11,25,5,40
"2011","South Cambridgeshire 007","E02003781","Total",2626,1753,857,896,36,240,166,74,566,520,9,31,6,31
"2011","South Cambridgeshire 009","E02003783","Total",2772,1917,1108,809,90,405,238,167,311,263,17,10,21,49
"2011","South Cambridgeshire 010","E02003784","Total",3395,2686,1324,1362,71,306,193,113,283,256,6,18,3,49
"2011","South Cambridgeshire 011","E02003785","Total",3602,2246,1208,1038,66,535,346,189,711,672,7,22,10,44
"2011","South Cambridgeshire 012","E02003786","Total",2673,1905,1159,746,44,370,300,70,322,302,1,11,8,32
"2011","South Cambridgeshire 013","E02003787","Total",3019,2217,1154,1063,33,428,328,100,279,241,8,25,5,62
"2011","South Cambridgeshire 014","E02003788","Total",2592,1986,1157,829,28,307,276,31,236,215,6,13,2,35
"2011","South Cambridgeshire 015","E02003789","Total",2992,2029,1030,999,84,606,433,173,239,212,4,21,2,34
"2011","South Cambridgeshire 016","E02003790","Total",3831,2779,1408,1371,50,582,476,106,342,303,12,21,6,78
"2011","South Cambridgeshire 017","E02003791","Total",3215,2248,1115,1133,27,517,358,159,369,315,31,17,6,54
"2011","South Cambridgeshire 018","E02003792","Total",3829,2755,1408,1347,65,659,464,195,300,257,20,17,6,50
"2011","South Cambridgeshire 019","E02003793","Total",2871,2030,980,1050,38,409,327,82,344,218,61,11,54,50
"2011","South Cambridgeshire 020","E02006873","Total",2608,1557,328,1229,196,429,22,407,408,389,1,15,3,18
"2011","South Cambridgeshire 021","E02006874","Total",3172,2093,822,1271,92,592,214,378,339,297,18,14,10,56
"2011","Basildon 001","E02004424","Total",2755,2578,1285,1293,4,19,12,7,136,123,1,11,1,18
"2011","Basildon 002","E02004425","Total",3169,2505,1158,1347,3,311,194,117,327,303,2,18,4,23
"2011","Basildon 003","E02004426","Total",3284,2580,1237,1343,4,365,200,165,314,296,2,16,0,21
"2011","Basildon 004","E02004427","Total",3333,2845,1665,1180,3,252,219,33,194,166,5,21,2,39
"2011","Basildon 005","E02004428","Total",2694,1936,992,944,10,443,387,56,289,268,5,15,1,16
"2011","Basildon 006","E02004429","Total",3111,2748,1513,1235,13,138,110,28,189,176,1,11,1,23
"2011","Basildon 007","E02004430","Total",3206,2901,1193,1708,8,43,13,30,244,221,3,19,1,10
"2011","Basildon 008","E02004431","Total",3814,2807,939,1868,57,397,184,213,531,493,4,33,1,22
"2011","Basildon 009","E02004432","Total",2604,2328,1233,1095,5,62,46,16,196,172,3,16,5,13
"2011","Basildon 010","E02004433","Total",3691,2272,838,1434,35,846,415,431,505,468,3,28,6,33
"2011","Basildon 011","E02004434","Total",3454,2049,647,1402,245,624,487,137,503,466,2,29,6,33
"2011","Basildon 012","E02004435","Total",3324,2026,803,1223,11,938,705,233,303,277,0,20,6,46
"2011","Basildon 013","E02004436","Total",3142,1220,393,827,17,1525,1228,297,344,324,1,16,3,36
"2011","Basildon 014","E02004437","Total",3583,2038,935,1103,47,1151,864,287,319,289,0,28,2,28
"2011","Basildon 015","E02004438","Total",3660,1832,790,1042,45,1311,936,375,420,391,3,22,4,52
"2011","Basildon 016","E02004439","Total",3472,1237,446,791,21,1760,714,1046,413,378,1,16,18,41
"2011","Basildon 017","E02004440","Total",3354,2094,923,1171,18,862,687,175,348,323,0,21,4,32
"2011","Basildon 018","E02004441","Total",3209,1643,683,960,14,1247,893,354,276,255,1,17,3,29
"2011","Basildon 019","E02004442","Total",3350,1198,436,762,56,1731,573,1158,329,297,0,21,11,36
"2011","Basildon 020","E02004443","Total",3415,2312,1101,1211,37,684,532,152,348,275,22,39,12,34
"2011","Basildon 021","E02004444","Total",3602,2823,1092,1731,54,351,248,103,354,328,5,15,6,20
"2011","Basildon 022","E02004445","Total",3520,2000,735,1265,13,916,662,254,566,536,1,27,2,25
"2011","Braintree 001","E02004446","Total",2749,2114,1003,1111,7,351,87,264,237,211,7,15,4,40
"2011","Braintree 002","E02004447","Total",2500,1913,1102,811,14,226,44,182,301,260,10,25,6,46
"2011","Braintree 003","E02004448","Total",2688,1932,969,963,17,320,79,241,382,360,6,11,5,37
"2011","Braintree 004","E02004449","Total",3831,2275,998,1277,23,910,260,650,590,549,2,29,10,33
"2011","Braintree 005","E02004450","Total",2548,1836,938,898,13,308,50,258,333,245,39,24,25,58
"2011","Braintree 006","E02004451","Total",3521,2700,1300,1400,8,381,92,289,383,350,4,24,5,49
"2011","Braintree 007","E02004452","Total",3522,2878,1224,1654,6,266,57,209,342,312,1,24,5,30
"2011","Braintree 008","E02004453","Total",2969,1480,633,847,36,1102,307,795,323,286,3,29,5,28
"2011","Braintree 009","E02004454","Total",4219,2375,1066,1309,33,512,86,426,1258,1185,9,58,6,41
"2011","Braintree 010","E02004455","Total",2884,2411,1058,1353,25,156,21,135,274,247,9,15,3,18
"2011","Braintree 011","E02004456","Total",3809,2303,853,1450,10,904,243,661,560,509,8,40,3,32
"2011","Braintree 012","E02004457","Total",4041,2556,1011,1545,45,999,220,779,395,367,4,20,4,46
"2011","Braintree 013","E02004458","Total",3540,2909,1081,1828,25,227,25,202,363,335,7,17,4,16
"2011","Braintree 014","E02004459","Total",4339,3116,1507,1609,8,629,156,473,531,478,8,35,10,55
"2011","Braintree 015","E02004460","Total",3706,2593,1169,1424,27,748,179,569,310,261,5,35,9,28
"2011","Braintree 016","E02004461","Total",2258,1277,371,906,2,732,176,556,231,198,3,27,3,16
"2011","Braintree 017","E02004462","Total",4655,2891,1202,1689,43,840,204,636,838,789,6,37,6,43
"2011","Braintree 018","E02004463","Total",3264,2313,1124,1189,20,444,92,352,432,390,17,20,5,55
"2011","Brentwood 001","E02004464","Total",3742,3181,1710,1471,16,332,208,124,165,139,8,13,5,48
"2011","Brentwood 002","E02004465","Total",2588,1962,1167,795,7,288,252,36,279,248,3,18,10,52
"2011","Brentwood 003","E02004466","Total",3314,2426,1183,1243,6,615,564,51,217,198,2,12,5,50
"2011","Brentwood 004","E02004467","Total",3062,2008,880,1128,24,709,530,179,284,253,3,22,6,37
"2011","Brentwood 005","E02004468","Total",4144,3677,2153,1524,4,55,50,5,376,338,9,24,5,32
"2011","Brentwood 006","E02004469","Total",2749,2346,1190,1156,13,120,105,15,236,208,11,13,4,34
"2011","Brentwood 007","E02004470","Total",5127,3027,1196,1831,110,680,274,406,1248,1173,19,45,11,62
"2011","Brentwood 008","E02004471","Total",3360,2215,1012,1203,9,726,681,45,361,327,7,20,7,49
"2011","Brentwood 009","E02004472","Total",2560,2186,1143,1043,5,61,39,22,286,264,3,17,2,22
"2011","Castle Point 001","E02004473","Total",3088,2658,1317,1341,7,102,91,11,298,279,0,17,2,23
"2011","Castle Point 002","E02004474","Total",2994,2637,1495,1142,16,79,36,43,237,215,0,20,2,25
"2011","Castle Point 003","E02004475","Total",2607,2318,1190,1128,6,80,80,0,180,161,1,15,3,23
"2011","Castle Point 004","E02004476","Total",3140,2838,1479,1359,7,33,25,8,232,206,0,23,3,30
"2011","Castle Point 005","E02004477","Total",2606,2375,1450,925,10,36,29,7,162,143,1,18,0,23
"2011","Castle Point 006","E02004478","Total",2864,2071,1085,986,6,303,234,69,456,410,1,39,6,28
"2011","Castle Point 007","E02004479","Total",3270,2807,1414,1393,9,113,74,39,311,280,2,26,3,30
"2011","Castle Point 008","E02004480","Total",2709,2265,917,1348,12,123,50,73,288,263,2,22,1,21
"2011","Castle Point 009","E02004481","Total",3194,2714,1750,964,12,74,66,8,372,336,2,30,4,22
"2011","Castle Point 010","E02004482","Total",3147,1950,798,1152,10,729,558,171,430,391,1,37,1,28
"2011","Castle Point 011","E02004483","Total",3460,2770,1455,1315,5,101,67,34,552,487,3,34,28,32
"2011","Castle Point 012","E02004484","Total",3361,2698,1341,1357,3,176,143,33,450,413,1,30,6,34
"2011","Chelmsford 001","E02004485","Total",2805,2024,942,1082,29,451,64,387,250,219,10,10,11,51
"2011","Chelmsford 002","E02004486","Total",3336,2751,1419,1332,21,205,19,186,341,313,9,15,4,18
"2011","Chelmsford 003","E02004487","Total",2946,1956,932,1024,21,660,138,522,250,218,8,19,5,59
"2011","Chelmsford 004","E02004488","Total",3446,2839,1182,1657,12,233,31,202,340,308,2,29,1,22
"2011","Chelmsford 005","E02004489","Total",3480,2620,1046,1574,29,493,48,445,301,264,5,26,6,37
"2011","Chelmsford 006","E02004490","Total",3275,1288,568,720,19,1586,291,1295,317,292,3,13,9,65
"2011","Chelmsford 007","E02004491","Total",2989,2529,1143,1386,13,71,13,58,343,315,0,23,5,33
"2011","Chelmsford 008","E02004492","Total",3910,2779,890,1889,22,450,81,369,641,602,7,26,6,18
"2011","Chelmsford 009","E02004493","Total",4209,2467,991,1476,27,904,136,768,763,712,4,35,12,48
"2011","Chelmsford 010","E02004494","Total",4664,2361,1014,1347,98,450,48,402,1694,1608,8,64,14,61
"2011","Chelmsford 011","E02004495","Total",3421,2614,1556,1058,7,461,68,393,294,260,8,20,6,45
"2011","Chelmsford 012","E02004496","Total",2874,2460,1135,1325,3,96,12,84,294,274,0,18,2,21
"2011","Chelmsford 013","E02004497","Total",3308,2751,1461,1290,20,207,44,163,292,266,3,21,2,38
"2011","Chelmsford 014","E02004498","Total",4209,2507,1094,1413,51,1189,187,1002,414,369,4,33,8,48
"2011","Chelmsford 015","E02004499","Total",2698,2414,1148,1266,18,83,6,77,165,149,3,12,1,18
"2011","Chelmsford 016","E02004500","Total",3647,2940,1517,1423,15,402,61,341,245,215,4,22,4,45
"2011","Chelmsford 017","E02004501","Total",3006,2287,1215,1072,6,498,104,394,191,165,2,19,5,24
"2011","Chelmsford 018","E02004502","Total",2791,2281,1335,946,9,230,52,178,236,211,11,12,2,35
"2011","Chelmsford 019","E02004503","Total",3257,2753,1184,1569,23,82,14,68,365,311,9,43,2,34
"2011","Chelmsford 020","E02004504","Total",3343,2592,902,1690,4,273,20,253,457,417,4,32,4,17
"2011","Chelmsford 021","E02004505","Total",2053,1765,1022,743,3,96,19,77,156,133,7,13,3,33
"2011","Colchester 001","E02004506","Total",2696,2189,1162,1027,12,233,166,67,228,196,7,20,5,34
"2011","Colchester 002","E02004507","Total",4172,2550,755,1795,38,596,90,506,971,900,9,60,2,17
"2011","Colchester 003","E02004508","Total",2620,2135,1120,1015,5,250,215,35,210,191,3,14,2,20
"2011","Colchester 004","E02004509","Total",4413,2803,988,1815,46,379,113,266,1155,1098,10,36,11,30
"2011","Colchester 007","E02004512","Total",4961,2347,1098,1249,31,566,186,380,1939,1841,6,79,13,78
"2011","Colchester 008","E02004513","Total",4268,1324,570,754,23,1748,1337,411,1122,1066,5,31,20,51
"2011","Colchester 009","E02004514","Total",2311,1826,1018,808,2,207,160,47,247,215,5,25,2,29
"2011","Colchester 010","E02004515","Total",2880,2363,1148,1215,5,182,133,49,299,285,3,8,3,31
"2011","Colchester 011","E02004516","Total",4437,2088,701,1387,15,770,210,560,1523,1431,5,63,24,41
"2011","Colchester 012","E02004517","Total",3506,2656,1276,1380,12,412,254,158,399,356,4,36,3,27
"2011","Colchester 013","E02004518","Total",2583,1781,822,959,13,146,54,92,622,488,45,30,59,21
"2011","Colchester 014","E02004519","Total",3076,2617,1553,1064,3,197,134,63,221,196,2,20,3,38
"2011","Colchester 015","E02004520","Total",3163,1374,543,831,17,813,514,299,928,305,335,41,247,31
"2011","Colchester 016","E02004521","Total",3904,2342,996,1346,13,819,650,169,700,652,7,38,3,30
"2011","Colchester 017","E02004522","Total",3457,2566,1435,1131,10,161,102,59,687,578,6,42,61,33
"2011","Colchester 018","E02004523","Total",3634,2249,871,1378,20,777,547,230,552,490,10,47,5,36
"2011","Colchester 019","E02004524","Total",3231,2751,1390,1361,8,169,131,38,251,220,8,17,6,52
"2011","Colchester 020","E02004525","Total",3293,2613,1471,1142,8,288,215,73,335,282,27,20,6,49
"2011","Colchester 021","E02004526","Total",3300,2711,1731,980,17,208,132,76,326,282,3,36,5,38
"2011","Colchester 022","E02006922","Total",5729,4222,2192,2030,27,748,551,197,675,617,5,48,5,57
"2011","Epping Forest 001","E02004527","Total",3667,2667,1175,1492,17,471,310,161,463,421,4,34,4,49
"2011","Epping Forest 002","E02004528","Total",3242,2767,1462,1305,3,263,225,38,166,153,4,6,3,43
"2011","Epping Forest 003","E02004529","Total",2582,1949,1009,940,10,278,248,30,290,262,9,10,9,55
"2011","Epping Forest 004","E02004530","Total",2626,1912,987,925,5,431,359,72,252,234,2,14,2,26
"2011","Epping Forest 005","E02004531","Total",2663,1879,908,971,11,516,377,139,215,193,7,7,8,42
"2011","Epping Forest 006","E02004532","Total",2764,1902,987,915,3,373,249,124,453,431,5,14,3,33
"2011","Epping Forest 007","E02004533","Total",2999,1827,811,1016,12,933,763,170,195,172,2,19,2,32
"2011","Epping Forest 008","E02004534","Total",3678,2448,913,1535,20,762,627,135,415,384,0,30,1,33
"2011","Epping Forest 009","E02004535","Total",2493,1836,1121,715,26,226,118,108,349,321,11,12,5,56
"2011","Epping Forest 010","E02004536","Total",2520,1988,1062,926,9,298,223,75,201,184,7,10,0,24
"2011","Epping Forest 011","E02004537","Total",3805,2061,775,1286,13,1257,1076,181,424,404,2,16,2,50
"2011","Epping Forest 012","E02004538","Total",3515,2837,1363,1474,27,178,136,42,441,417,3,19,2,32
"2011","Epping Forest 013","E02004539","Total",3188,2214,978,1236,12,630,602,28,292,271,1,16,4,40
"2011","Epping Forest 014","E02004540","Total",2457,1927,925,1002,6,207,151,56,288,264,3,19,2,29
"2011","Epping Forest 015","E02004541","Total",4894,3652,1744,1908,17,427,321,106,745,697,7,38,3,53
"2011","Epping Forest 016","E02004542","Total",2396,1974,1007,967,11,120,87,33,242,201,25,8,8,49
"2011","Epping Forest 017","E02004543","Total",2502,1725,843,882,4,433,336,97,311,298,1,10,2,29
"2011","Harlow 001","E02004544","Total",3012,1833,773,1060,70,714,556,158,358,332,0,19,7,37
"2011","Harlow 002","E02004545","Total",3025,1433,591,842,26,1230,1154,76,309,278,4,26,1,27
"2011","Harlow 003","E02004546","Total",3260,1490,583,907,12,1300,1224,76,419,389,1,26,3,39
"2011","Harlow 004","E02004547","Total",3369,1573,607,966,80,1235,995,240,435,399,4,25,7,46
"2011","Harlow 005","E02004548","Total",3513,2882,736,2146,27,151,13,138,438,410,1,26,1,15
"2011","Harlow 006","E02004549","Total",3244,1731,719,1012,9,1225,1197,28,257,225,5,23,4,22
"2011","Harlow 007","E02004550","Total",3331,1618,686,932,20,1197,967,230,464,443,1,17,3,32
"2011","Harlow 008","E02004551","Total",3180,1673,686,987,5,1240,1151,89,246,224,1,17,4,16
"2011","Harlow 009","E02004552","Total",2748,1853,750,1103,9,630,535,95,230,217,1,11,1,26
"2011","Harlow 010","E02004553","Total",2949,1563,587,976,45,1063,790,273,254,235,1,18,0,24
"2011","Harlow 011","E02004554","Total",2989,1780,633,1147,23,823,745,78,346,322,2,19,3,17
"2011","Maldon 001","E02004555","Total",2503,2034,1070,964,9,211,13,198,220,188,6,24,2,29
"2011","Maldon 002","E02004556","Total",2912,2472,1422,1050,1,183,13,170,212,180,6,23,3,44
"2011","Maldon 003","E02004557","Total",3365,2587,1080,1507,26,417,15,402,313,276,1,32,4,22
"2011","Maldon 004","E02004558","Total",3059,1909,1136,773,19,604,35,569,484,453,5,18,8,43
"2011","Maldon 005","E02004559","Total",3147,2628,1309,1319,4,307,22,285,189,168,1,19,1,19
"2011","Maldon 006","E02004560","Total",3383,2634,1232,1402,14,317,21,296,370,333,10,23,4,48
"2011","Maldon 007","E02004561","Total",3929,3342,1629,1713,14,245,12,233,287,242,7,30,8,41
"2011","Maldon 008","E02004562","Total",3519,2645,1436,1209,10,401,26,375,418,368,9,37,4,45
"2011","Rochford 001","E02004563","Total",2786,2528,1560,968,8,75,4,71,157,138,2,16,1,18
"2011","Rochford 002","E02004564","Total",3122,2814,1395,1419,13,65,9,56,207,173,2,29,3,23
"2011","Rochford 003","E02004565","Total",5929,5285,2738,2547,4,225,48,177,377,334,6,33,4,38
"2011","Rochford 004","E02004566","Total",2379,1253,558,695,6,767,98,669,319,296,6,13,4,34
"2011","Rochford 005","E02004567","Total",3133,2873,1467,1406,5,59,8,51,176,161,1,14,0,20
"2011","Rochford 006","E02004568","Total",3372,2693,953,1740,7,335,70,265,309,277,5,21,6,28
"2011","Rochford 007","E02004569","Total",3133,2396,1150,1246,11,219,30,189,475,436,2,35,2,32
"2011","Rochford 008","E02004570","Total",3591,2772,1492,1280,13,437,53,384,340,320,1,19,0,29
"2011","Rochford 009","E02004571","Total",3141,2919,1579,1340,2,40,12,28,162,146,1,15,0,18
"2011","Rochford 010","E02004572","Total",2978,2289,1035,1254,10,325,74,251,322,254,5,25,38,32
"2011","Tendring 001","E02004573","Total",2873,1526,806,720,10,428,299,129,871,822,6,39,4,38
"2011","Tendring 002","E02004574","Total",3127,2035,1037,998,25,533,343,190,486,450,1,28,7,48
"2011","Tendring 003","E02004575","Total",4812,3586,1860,1726,14,499,404,95,632,582,11,31,8,81
"2011","Tendring 004","E02004576","Total",3736,3120,1721,1399,14,225,162,63,327,288,5,33,1,50
"2011","Tendring 005","E02004577","Total",2082,1686,909,777,7,157,118,39,197,174,6,12,5,35
"2011","Tendring 006","E02004578","Total",3423,2369,1668,701,7,270,147,123,712,655,9,42,6,65
"2011","Tendring 007","E02004579","Total",2992,2506,1503,1003,13,167,141,26,258,210,11,35,2,48
"2011","Tendring 008","E02004580","Total",5535,4619,3181,1438,12,258,115,143,586,526,3,51,6,60
"2011","Tendring 009","E02004581","Total",3101,2675,1552,1123,5,127,97,30,262,235,2,19,6,32
"2011","Tendring 010","E02004582","Total",3188,2655,1737,918,10,186,2,184,294,241,4,40,9,43
"2011","Tendring 011","E02004583","Total",3703,2806,1575,1231,10,228,143,85,622,575,2,43,2,37
"2011","Tendring 012","E02004584","Total",3205,2819,2053,766,8,51,24,27,300,275,1,21,3,27
"2011","Tendring 013","E02004585","Total",3312,2602,1498,1104,19,225,75,150,437,384,5,43,5,29
"2011","Tendring 014","E02004586","Total",3631,2477,1528,949,14,269,89,180,839,775,3,57,4,32
"2011","Tendring 015","E02004587","Total",3338,1903,1027,876,15,866,513,353,504,458,2,41,3,50
"2011","Tendring 016","E02004588","Total",3019,1369,748,621,25,302,127,175,1285,1227,7,35,16,38
"2011","Tendring 017","E02004589","Total",3141,2274,1361,913,16,224,113,111,590,546,1,39,4,37
"2011","Tendring 018","E02004590","Total",3887,2725,1932,793,14,228,76,152,862,787,9,55,11,58
"2011","Uttlesford 001","E02004591","Total",2705,2118,1078,1040,32,184,151,33,318,289,5,21,3,53
"2011","Uttlesford 002","E02004592","Total",5158,3322,1652,1670,53,994,530,464,715,638,12,52,13,74
"2011","Uttlesford 003","E02004593","Total",3190,2414,1282,1132,26,373,300,73,320,290,13,14,3,57
"2011","Uttlesford 004","E02004594","Total",2933,2011,1045,966,32,372,274,98,470,281,106,21,62,48
"2011","Uttlesford 005","E02004595","Total",4711,3659,1609,2050,15,374,259,115,593,548,6,34,5,70
"2011","Uttlesford 006","E02004596","Total",2959,1941,846,1095,60,447,279,168,467,435,7,16,9,44
"2011","Uttlesford 007","E02004597","Total",3075,1985,860,1125,64,539,322,217,455,431,4,19,1,32
"2011","Uttlesford 008","E02004598","Total",3825,2919,1348,1571,21,360,261,99,463,419,8,26,10,62
"2011","Uttlesford 009","E02004599","Total",2760,2056,948,1108,18,318,284,34,307,277,8,17,5,61
"2011","Broxbourne 001","E02004843","Total",2648,2299,1125,1174,17,128,13,115,187,170,2,13,2,17
"2011","Broxbourne 002","E02004844","Total",2767,2044,802,1242,19,421,64,357,265,249,1,14,1,18
"2011","Broxbourne 003","E02004845","Total",3367,2146,995,1151,19,563,67,496,602,554,6,38,4,37
"2011","Broxbourne 004","E02004846","Total",2398,2127,1162,965,1,73,10,63,183,174,0,8,1,14
"2011","Broxbourne 005","E02004847","Total",4040,2658,987,1671,65,770,115,655,514,478,1,32,3,33
"2011","Broxbourne 006","E02004848","Total",2673,2094,884,1210,12,302,195,107,248,231,3,13,1,17
"2011","Broxbourne 007","E02004849","Total",2486,2142,922,1220,67,107,14,93,145,136,0,9,0,25
"2011","Broxbourne 008","E02004850","Total",3064,2242,983,1259,6,537,105,432,266,249,2,15,0,13
"2011","Broxbourne 009","E02004851","Total",2315,1720,720,1000,65,359,59,300,155,147,1,7,0,16
"2011","Broxbourne 010","E02004852","Total",3144,2336,1082,1254,10,329,34,295,443,418,2,15,8,26
"2011","Broxbourne 011","E02004853","Total",2576,1735,754,981,14,661,117,544,148,129,4,14,1,18
"2011","Broxbourne 012","E02004854","Total",3017,2288,1194,1094,25,240,76,164,440,420,1,17,2,24
"2011","Broxbourne 013","E02004855","Total",3163,1629,652,977,98,807,237,570,603,579,1,16,7,26
"2011","Dacorum 001","E02004856","Total",2247,1572,665,907,7,354,323,31,279,259,4,14,2,35
"2011","Dacorum 002","E02004857","Total",2350,1802,863,939,10,211,183,28,303,275,8,16,4,24
"2011","Dacorum 003","E02004858","Total",2069,1412,577,835,7,428,388,40,206,175,12,13,6,16
"2011","Dacorum 004","E02004859","Total",2141,1727,934,793,4,175,136,39,216,194,11,8,3,19
"2011","Dacorum 005","E02004860","Total",2516,1483,485,998,13,482,160,322,534,509,0,24,1,4
"2011","Dacorum 006","E02004861","Total",2394,1839,1081,758,8,267,184,83,244,221,9,10,4,36
"2011","Dacorum 007","E02004862","Total",3130,1607,549,1058,10,1163,782,381,332,307,2,20,3,18
"2011","Dacorum 008","E02004863","Total",3194,1237,489,748,73,1537,1220,317,315,292,0,20,3,32
"2011","Dacorum 009","E02004864","Total",2852,2208,1129,1079,4,120,37,83,486,433,25,22,6,34
"2011","Dacorum 010","E02004865","Total",2415,1454,573,881,2,607,532,75,333,304,2,21,6,19
"2011","Dacorum 011","E02004866","Total",2707,1513,581,932,10,928,861,67,234,211,0,23,0,22
"2011","Dacorum 012","E02004867","Total",2401,1664,787,877,28,508,443,65,183,168,1,14,0,18
"2011","Dacorum 013","E02004868","Total",2387,1297,598,699,40,774,726,48,249,228,4,15,2,27
"2011","Dacorum 014","E02004869","Total",2293,1606,745,861,6,350,326,24,314,299,2,13,0,17
"2011","Dacorum 015","E02004870","Total",4059,2153,869,1284,68,1176,841,335,614,580,5,26,3,48
"2011","Dacorum 016","E02004871","Total",2064,1290,540,750,2,582,566,16,173,156,2,14,1,17
"2011","Dacorum 017","E02004872","Total",2801,2071,1068,1003,5,522,461,61,182,165,1,16,0,21
"2011","Dacorum 018","E02004873","Total",4440,3085,1309,1776,21,492,311,181,811,754,9,36,12,31
"2011","Dacorum 019","E02004874","Total",2421,1505,618,887,13,629,434,195,258,233,1,17,7,16
"2011","Dacorum 020","E02004875","Total",3541,2077,812,1265,24,1122,971,151,289,259,5,21,4,29
"2011","Dacorum 021","E02004876","Total",3381,2685,1389,1296,13,316,243,73,334,306,11,12,5,33
"2011","Dacorum 022","E02004877","Total",2135,1590,797,793,5,302,279,23,218,188,15,11,4,20
"2011","East Hertfordshire 001","E02004878","Total",2653,2110,1026,1084,4,277,51,226,220,204,0,13,3,42
"2011","East Hertfordshire 002","E02004879","Total",3084,2233,1141,1092,18,481,94,387,279,240,14,19,6,73
"2011","East Hertfordshire 003","E02004880","Total",3492,2782,1240,1542,67,238,45,193,349,315,14,14,6,56
"2011","East Hertfordshire 004","E02004881","Total",2587,1810,911,899,36,191,12,179,523,494,6,22,1,27
"2011","East Hertfordshire 005","E02004882","Total",3023,2149,996,1153,50,330,69,261,462,434,6,18,4,32
"2011","East Hertfordshire 006","E02004883","Total",2308,1749,772,977,5,293,40,253,212,187,9,11,5,49
"2011","East Hertfordshire 007","E02004884","Total",4233,2461,950,1511,68,880,112,768,783,743,3,35,2,41
"2011","East Hertfordshire 008","E02004885","Total",3222,2841,1084,1757,14,50,12,38,303,280,3,18,2,14
"2011","East Hertfordshire 009","E02004886","Total",2204,1497,742,755,8,383,72,311,260,235,12,7,6,56
"2011","East Hertfordshire 010","E02004887","Total",2914,2127,1067,1060,13,367,49,318,366,345,10,4,7,41
"2011","East Hertfordshire 011","E02004888","Total",3587,2754,1358,1396,28,298,73,225,473,447,3,18,5,34
"2011","East Hertfordshire 012","E02004889","Total",4368,2986,1311,1675,27,713,133,580,600,564,3,27,6,42
"2011","East Hertfordshire 013","E02004890","Total",3643,2587,1082,1505,37,391,53,338,600,564,6,24,6,28
"2011","East Hertfordshire 014","E02004891","Total",3270,2448,1166,1282,5,334,37,297,452,423,7,15,7,31
"2011","East Hertfordshire 015","E02004892","Total",2449,1471,626,845,20,746,113,633,177,164,1,10,2,35
"2011","East Hertfordshire 016","E02004893","Total",2129,1635,504,1131,25,232,33,199,224,210,2,10,2,13
"2011","East Hertfordshire 017","E02004894","Total",3810,2494,1063,1431,52,472,57,415,739,686,9,38,6,53
"2011","East Hertfordshire 018","E02004895","Total",3601,2531,1147,1384,31,509,74,435,424,371,23,19,11,106
"2011","Hertsmere 001","E02004896","Total",3263,2614,1594,1020,9,118,5,113,484,451,5,25,3,38
"2011","Hertsmere 002","E02004897","Total",2588,2045,1019,1026,13,312,6,306,196,176,3,15,2,22
"2011","Hertsmere 003","E02004898","Total",3040,2018,969,1049,20,704,157,547,276,251,1,22,2,22
"2011","Hertsmere 004","E02004899","Total",2101,1420,522,898,35,402,48,354,203,190,2,5,6,41
"2011","Hertsmere 005","E02004900","Total",3143,2481,1307,1174,16,252,11,241,357,345,1,7,4,37
"2011","Hertsmere 006","E02004901","Total",3485,1501,562,939,50,1615,212,1403,264,249,2,12,1,55
"2011","Hertsmere 007","E02004902","Total",3173,1763,683,1080,30,864,85,779,468,450,2,15,1,48
"2011","Hertsmere 008","E02004903","Total",2591,1688,748,940,43,422,29,393,410,390,8,6,6,28
"2011","Hertsmere 009","E02004904","Total",2486,1372,495,877,87,693,72,621,308,283,1,21,3,26
"2011","Hertsmere 010","E02004905","Total",2405,1825,776,1049,17,138,12,126,365,320,22,21,2,60
"2011","Hertsmere 011","E02004906","Total",3738,2309,880,1429,117,695,75,620,578,553,3,19,3,39
"2011","Hertsmere 012","E02004907","Total",3774,2717,1290,1427,19,514,29,485,486,435,19,15,17,38
"2011","Hertsmere 013","E02004908","Total",3991,3144,1644,1500,15,203,15,188,586,407,92,25,62,43
"2011","North Hertfordshire 001","E02004909","Total",2175,1409,560,849,5,391,144,247,348,324,3,19,2,22
"2011","North Hertfordshire 002","E02004910","Total",4431,3479,1626,1853,3,381,165,216,539,500,6,25,8,29
"2011","North Hertfordshire 003","E02004911","Total",2935,1555,696,859,17,1149,429,720,183,145,3,25,10,31
"2011","North Hertfordshire 004","E02004912","Total",4375,2956,1320,1636,58,737,306,431,579,530,3,33,13,45
"2011","North Hertfordshire 005","E02004913","Total",5796,4091,1558,2533,110,703,227,476,798,728,24,30,16,94
"2011","North Hertfordshire 006","E02004914","Total",3115,1705,752,953,5,976,171,805,403,374,4,21,4,26
"2011","North Hertfordshire 007","E02004915","Total",2335,1157,530,627,57,793,178,615,307,288,1,12,6,21
"2011","North Hertfordshire 008","E02004916","Total",2933,2010,1173,837,10,599,193,406,280,256,5,13,6,34
"2011","North Hertfordshire 009","E02004917","Total",2672,1671,814,857,5,828,371,457,157,140,3,9,5,11
"2011","North Hertfordshire 010","E02004918","Total",3615,2151,823,1328,100,411,112,299,917,875,2,35,5,36
"2011","North Hertfordshire 011","E02004919","Total",3073,2011,855,1156,37,603,283,320,401,382,2,12,5,21
"2011","North Hertfordshire 012","E02004920","Total",4660,2939,1530,1409,39,1049,496,553,578,535,6,29,8,55
"2011","North Hertfordshire 013","E02004921","Total",3216,2483,1250,1233,6,230,118,112,466,439,7,19,1,31
"2011","North Hertfordshire 014","E02004922","Total",3859,2406,1197,1209,6,821,346,475,553,500,16,19,18,73
"2011","North Hertfordshire 015","E02004923","Total",4236,3049,1517,1532,14,633,235,398,484,444,12,23,5,56
"2011","St Albans 001","E02004924","Total",2644,2222,1026,1196,5,184,153,31,214,198,2,11,3,19
"2011","St Albans 002","E02004925","Total",2907,2091,948,1143,9,431,326,105,346,317,8,17,4,30
"2011","St Albans 003","E02004926","Total",3114,2392,1342,1050,0,135,84,51,561,516,20,20,5,26
"2011","St Albans 004","E02004927","Total",2582,1954,1027,927,10,387,341,46,188,167,9,9,3,43
"2011","St Albans 005","E02004928","Total",2639,2317,1265,1052,2,107,97,10,192,182,1,8,1,21
"2011","St Albans 006","E02004929","Total",2534,1879,939,940,14,347,262,85,255,225,7,12,11,39
"2011","St Albans 007","E02004930","Total",2778,2147,971,1176,1,287,237,50,319,292,2,22,3,24
"2011","St Albans 008","E02004931","Total",2613,2028,1029,999,7,303,217,86,246,221,2,19,4,29
"2011","St Albans 009","E02004932","Total",2880,1806,698,1108,8,814,484,330,227,214,0,13,0,25
"2011","St Albans 010","E02004933","Total",2505,2110,1048,1062,7,86,69,17,283,263,4,12,4,19
"2011","St Albans 011","E02004934","Total",2997,1803,781,1022,59,321,201,120,782,753,3,22,4,32
"2011","St Albans 012","E02004935","Total",3661,1875,757,1118,35,496,224,272,1212,1148,8,37,19,43
"2011","St Albans 013","E02004936","Total",2284,1787,697,1090,6,97,46,51,382,363,5,13,1,12
"2011","St Albans 014","E02004937","Total",2707,2265,1348,917,2,30,15,15,369,347,7,12,3,41
"2011","St Albans 015","E02004938","Total",2282,1614,665,949,9,415,189,226,224,182,27,9,6,20
"2011","St Albans 016","E02004939","Total",2682,1708,890,818,6,643,510,133,290,264,8,12,6,35
"2011","St Albans 017","E02004940","Total",2975,1716,661,1055,6,762,643,119,457,425,4,22,6,34
"2011","St Albans 018","E02004941","Total",3763,2530,936,1594,48,599,394,205,551,508,6,21,16,35
"2011","St Albans 019","E02004942","Total",2513,1917,964,953,11,302,194,108,250,233,3,12,2,33
"2011","St Albans 020","E02004943","Total",3080,2670,1417,1253,16,86,67,19,276,247,5,12,12,32
"2011","Stevenage 001","E02004944","Total",2559,1495,442,1053,20,709,631,78,315,288,0,25,2,20
"2011","Stevenage 002","E02004945","Total",4756,2913,1171,1742,152,1054,622,432,605,552,4,45,4,32
"2011","Stevenage 003","E02004946","Total",2632,1472,556,916,47,761,413,348,331,295,0,35,1,21
"2011","Stevenage 004","E02004947","Total",2632,2054,723,1331,6,235,182,53,323,299,0,23,1,14
"2011","Stevenage 005","E02004948","Total",2611,1365,510,855,6,807,637,170,422,399,1,20,2,11
"2011","Stevenage 006","E02004949","Total",3689,1857,793,1064,57,1259,970,289,471,428,2,35,6,45
"2011","Stevenage 007","E02004950","Total",2710,1695,662,1033,68,674,587,87,258,222,0,33,3,15
"2011","Stevenage 008","E02004951","Total",3041,1330,591,739,22,1317,1181,136,341,314,1,26,0,31
"2011","Stevenage 009","E02004952","Total",2694,1704,562,1142,9,692,667,25,278,257,1,20,0,11
"2011","Stevenage 010","E02004953","Total",2467,1327,501,826,9,916,848,68,196,175,3,14,4,19
"2011","Stevenage 011","E02004954","Total",2673,1500,559,941,18,870,689,181,269,238,4,25,2,16
"2011","Stevenage 012","E02004955","Total",2434,1627,666,961,8,608,537,71,171,163,0,8,0,20
"2011","Three Rivers 001","E02004956","Total",3738,2731,1344,1387,45,514,117,397,413,389,2,16,6,35
"2011","Three Rivers 002","E02004957","Total",3536,2466,882,1584,14,685,201,484,351,327,1,18,5,20
"2011","Three Rivers 003","E02004958","Total",2861,2303,1136,1167,27,290,88,202,207,177,9,20,1,34
"2011","Three Rivers 004","E02004959","Total",2237,1794,996,798,3,60,14,46,322,293,16,9,4,58
"2011","Three Rivers 005","E02004960","Total",2184,1761,965,796,3,147,34,113,250,235,3,9,3,23
"2011","Three Rivers 006","E02004961","Total",3681,3079,1446,1633,11,187,30,157,374,347,4,20,3,30
"2011","Three Rivers 007","E02004962","Total",3517,2525,1117,1408,11,475,126,349,465,429,11,24,1,41
"2011","Three Rivers 008","E02004963","Total",2736,1771,721,1050,27,725,260,465,200,177,3,20,0,13
"2011","Three Rivers 009","E02004964","Total",2314,1432,561,871,8,602,183,419,256,230,1,21,4,16
"2011","Three Rivers 010","E02004965","Total",2754,2215,1175,1040,8,279,97,182,226,195,4,22,5,26
"2011","Three Rivers 011","E02004966","Total",2465,2003,1183,820,5,49,9,40,373,217,111,9,36,35
"2011","Three Rivers 012","E02004967","Total",3085,1452,462,990,32,1305,521,784,271,237,2,22,10,25
"2011","Watford 001","E02004968","Total",3002,1863,665,1198,22,773,201,572,325,299,2,22,2,19
"2011","Watford 002","E02004969","Total",2792,2013,862,1151,14,445,133,312,303,260,12,28,3,17
"2011","Watford 003","E02004970","Total",3229,1836,748,1088,41,1089,352,737,247,224,1,17,5,16
"2011","Watford 004","E02004971","Total",2774,1718,600,1118,14,615,158,457,404,381,3,17,3,23
"2011","Watford 005","E02004972","Total",2456,1865,862,1003,5,124,26,98,443,426,3,14,0,19
"2011","Watford 006","E02004973","Total",3161,1943,532,1411,15,211,72,139,974,922,7,42,3,18
"2011","Watford 007","E02004974","Total",3173,2200,1022,1178,33,202,29,173,706,654,6,34,12,32
"2011","Watford 008","E02004975","Total",2938,2269,1105,1164,51,181,24,157,411,379,8,18,6,26
"2011","Watford 009","E02004976","Total",3948,1719,604,1115,82,710,103,607,1385,1317,10,49,9,52
"2011","Watford 010","E02004977","Total",2971,1767,600,1167,18,250,36,214,913,867,9,27,10,23
"2011","Watford 011","E02004978","Total",3460,1459,520,939,120,1003,233,770,860,816,7,29,8,18
"2011","Watford 012","E02004979","Total",2777,1956,834,1122,11,384,102,282,400,385,0,8,7,26
"2011","Welwyn Hatfield 001","E02004980","Total",2387,2057,1053,1004,6,133,111,22,172,159,1,9,3,19
"2011","Welwyn Hatfield 002","E02004981","Total",2883,2023,910,1113,12,487,308,179,326,300,6,16,4,35
"2011","Welwyn Hatfield 003","E02004982","Total",2408,1674,873,801,13,549,520,29,147,134,1,10,2,25
"2011","Welwyn Hatfield 004","E02004983","Total",2581,1496,615,881,9,803,682,121,237,217,2,17,1,36
"2011","Welwyn Hatfield 005","E02004984","Total",2878,1679,647,1032,5,834,483,351,335,322,2,10,1,25
"2011","Welwyn Hatfield 006","E02004985","Total",2997,1934,1046,888,19,717,469,248,289,279,0,7,3,38
"2011","Welwyn Hatfield 007","E02004986","Total",2935,1004,303,701,41,1594,1256,338,263,253,0,8,2,33
"2011","Welwyn Hatfield 008","E02004987","Total",2732,1544,620,924,26,968,613,355,164,146,4,7,7,30
"2011","Welwyn Hatfield 009","E02004988","Total",3018,1524,496,1028,41,1092,832,260,329,294,13,15,7,32
"2011","Welwyn Hatfield 010","E02004989","Total",3831,1700,634,1066,77,1117,739,378,893,842,7,24,20,44
"2011","Welwyn Hatfield 011","E02004990","Total",2613,1288,628,660,39,696,483,213,526,495,4,19,8,64
"2011","Welwyn Hatfield 012","E02004991","Total",2965,951,435,516,39,1197,896,301,733,700,7,20,6,45
"2011","Welwyn Hatfield 013","E02004992","Total",2795,1077,511,566,52,859,706,153,777,748,2,20,7,30
"2011","Welwyn Hatfield 014","E02004993","Total",2273,1319,666,653,9,546,490,56,356,328,7,13,8,43
"2011","Welwyn Hatfield 015","E02004994","Total",2224,1906,1056,850,3,67,63,4,200,163,22,11,4,48
"2011","Welwyn Hatfield 016","E02004995","Total",2093,1819,1068,751,4,82,42,40,164,152,2,8,2,24
"2011","Breckland 001","E02005503","Total",2896,2070,1186,884,9,276,49,227,482,339,69,26,48,59
"2011","Breckland 002","E02005504","Total",3694,2646,1592,1054,11,490,80,410,453,394,26,31,2,94
"2011","Breckland 003","E02005505","Total",2955,2080,1068,1012,14,451,84,367,367,329,8,26,4,43
"2011","Breckland 004","E02005506","Total",2843,2197,1174,1023,7,267,38,229,332,284,7,40,1,40
"2011","Breckland 005","E02005507","Total",5130,3316,1759,1557,21,803,122,681,919,851,5,60,3,71
"2011","Breckland 006","E02005508","Total",2814,2198,1225,973,23,299,60,239,236,197,7,32,0,58
"2011","Breckland 007","E02005509","Total",3258,2107,1380,727,25,632,111,521,446,398,12,32,4,48
"2011","Breckland 008","E02005510","Total",2931,2211,1379,832,11,346,42,304,305,272,6,25,2,58
"2011","Breckland 009","E02005511","Total",3226,2310,1442,868,13,328,52,276,540,464,29,34,13,35
"2011","Breckland 010","E02005512","Total",3155,2277,1113,1164,39,308,34,274,447,395,17,29,6,84
"2011","Breckland 011","E02005513","Total",3893,2683,1362,1321,33,482,76,406,632,571,6,45,10,63
"2011","Breckland 012","E02005514","Total",2840,1981,1110,871,5,309,36,273,474,427,16,23,8,71
"2011","Breckland 013","E02005515","Total",2471,1853,943,910,7,173,26,147,382,335,22,21,4,56
"2011","Breckland 014","E02005516","Total",2742,2002,1154,848,5,257,43,214,375,328,25,19,3,103
"2011","Breckland 015","E02005517","Total",2255,948,356,592,10,872,190,682,398,372,4,12,10,27
"2011","Breckland 016","E02005518","Total",4329,2905,1216,1689,69,206,24,182,1113,1011,30,58,14,36
"2011","Breckland 017","E02005519","Total",3087,1643,708,935,8,1012,220,792,393,339,8,33,13,31
"2011","Broadland 001","E02005520","Total",3347,2461,1575,886,17,423,55,368,397,342,9,33,13,49
"2011","Broadland 002","E02005521","Total",3600,2541,1399,1142,15,403,49,354,571,502,32,30,7,70
"2011","Broadland 003","E02005522","Total",2246,1622,884,738,15,236,18,218,334,292,7,24,11,39
"2011","Broadland 004","E02005523","Total",3038,2442,1180,1262,18,200,19,181,338,302,6,27,3,40
"2011","Broadland 005","E02005524","Total",2336,1946,1072,874,13,171,15,156,180,154,0,22,4,26
"2011","Broadland 006","E02005525","Total",4101,3406,1524,1882,33,212,15,197,426,387,2,37,0,24
"2011","Broadland 007","E02005526","Total",2278,1760,837,923,18,177,11,166,304,279,4,18,3,19
"2011","Broadland 008","E02005527","Total",3336,2721,1442,1279,27,273,25,248,282,253,1,26,2,33
"2011","Broadland 009","E02005528","Total",3678,2920,1534,1386,19,352,47,305,367,307,20,34,6,20
"2011","Broadland 010","E02005529","Total",2637,2178,1389,789,6,274,18,256,160,144,1,12,3,19
"2011","Broadland 011","E02005530","Total",2233,1958,1135,823,12,57,3,54,193,166,2,25,0,13
"2011","Broadland 012","E02005531","Total",2364,1811,955,856,10,323,36,287,190,160,1,26,3,30
"2011","Broadland 013","E02005532","Total",3160,2839,1792,1047,19,46,4,42,221,198,0,22,1,35
"2011","Broadland 014","E02005533","Total",3521,2772,1512,1260,14,399,50,349,290,240,15,24,11,46
"2011","Broadland 015","E02005534","Total",3362,2738,1562,1176,11,333,35,298,234,207,2,24,1,46
"2011","Broadland 016","E02005535","Total",2998,2247,983,1264,21,219,16,203,492,446,1,43,2,19
"2011","Broadland 017","E02005536","Total",2492,2020,1150,870,5,170,25,145,261,233,8,18,2,36
"2011","Broadland 018","E02005537","Total",2609,1961,1155,806,31,299,39,260,279,248,6,21,4,39
"2011","Great Yarmouth 001","E02005538","Total",3959,3323,2080,1243,11,223,207,16,338,280,12,38,8,64
"2011","Great Yarmouth 002","E02005539","Total",3153,2454,1407,1047,9,278,253,25,334,289,8,31,6,78
"2011","Great Yarmouth 003","E02005540","Total",4138,3319,2033,1286,22,277,234,43,466,419,9,37,1,54
"2011","Great Yarmouth 004","E02005541","Total",2553,1496,844,652,7,575,517,58,425,395,1,26,3,50
"2011","Great Yarmouth 005","E02005542","Total",3067,1226,675,551,17,719,464,255,1057,997,9,40,11,48
"2011","Great Yarmouth 006","E02005543","Total",3763,1159,627,532,16,1330,1092,238,1205,1152,7,29,17,53
"2011","Great Yarmouth 007","E02005544","Total",2927,1474,646,828,9,595,382,213,815,764,5,38,8,34
"2011","Great Yarmouth 008","E02005545","Total",2732,2377,1277,1100,22,109,84,25,189,165,1,22,1,35
"2011","Great Yarmouth 009","E02005546","Total",3620,1862,955,907,4,1169,1086,83,519,459,2,51,7,66
"2011","Great Yarmouth 010","E02005547","Total",3826,2641,1429,1212,8,273,203,70,870,792,16,49,13,34
"2011","Great Yarmouth 011","E02005548","Total",3056,1509,762,747,6,1216,958,258,240,165,26,29,20,85
"2011","Great Yarmouth 012","E02005549","Total",2323,1980,1070,910,6,128,122,6,183,162,5,13,3,26
"2011","Great Yarmouth 013","E02005550","Total",2962,2253,1219,1034,9,363,222,141,285,241,16,24,4,52
"2011","King's Lynn and West Norfolk 001","E02005551","Total",2661,1887,1407,480,6,268,44,224,454,409,12,29,4,46
"2011","King's Lynn and West Norfolk 002","E02005552","Total",3330,2153,1514,639,12,500,99,401,524,457,24,29,14,141
"2011","King's Lynn and West Norfolk 003","E02005553","Total",4228,3256,2300,956,22,393,58,335,474,428,5,34,7,83
"2011","King's Lynn and West Norfolk 004","E02005554","Total",3248,2261,1487,774,9,331,58,273,517,455,20,27,15,130
"2011","King's Lynn and West Norfolk 005","E02005555","Total",2777,2434,1384,1050,11,78,9,69,231,207,3,17,4,23
"2011","King's Lynn and West Norfolk 006","E02005556","Total",3122,2566,1247,1319,17,193,32,161,321,284,3,30,4,25
"2011","King's Lynn and West Norfolk 007","E02005557","Total",2413,962,398,564,4,973,326,647,407,357,5,34,11,67
"2011","King's Lynn and West Norfolk 008","E02005558","Total",2846,2233,1211,1022,5,336,61,275,232,195,13,19,5,40
"2011","King's Lynn and West Norfolk 009","E02005559","Total",2847,1852,896,956,8,485,157,328,465,419,1,32,13,37
"2011","King's Lynn and West Norfolk 010","E02005560","Total",3379,1853,691,1162,67,809,188,621,613,566,8,30,9,37
"2011","King's Lynn and West Norfolk 011","E02005561","Total",4518,1937,1020,917,34,1268,277,991,1196,1114,11,48,23,83
"2011","King's Lynn and West Norfolk 012","E02005562","Total",3052,2214,1287,927,9,359,120,239,380,334,17,28,1,90
"2011","King's Lynn and West Norfolk 013","E02005563","Total",2961,2433,1275,1158,3,266,55,211,211,171,9,21,10,48
"2011","King's Lynn and West Norfolk 014","E02005564","Total",3801,2627,1526,1101,7,272,46,226,839,344,310,22,163,56
"2011","King's Lynn and West Norfolk 015","E02005565","Total",2878,2224,1112,1112,10,265,56,209,317,277,6,29,5,62
"2011","King's Lynn and West Norfolk 016","E02005566","Total",3969,3051,1650,1401,14,419,96,323,415,345,11,51,8,70
"2011","King's Lynn and West Norfolk 017","E02005567","Total",4637,3296,2089,1207,25,521,107,414,724,672,7,41,4,71
"2011","King's Lynn and West Norfolk 018","E02005568","Total",3059,2245,1228,1017,2,326,83,243,410,362,14,25,9,76
"2011","King's Lynn and West Norfolk 019","E02005569","Total",3251,2223,1186,1037,10,331,74,257,548,436,56,35,21,139
"2011","North Norfolk 001","E02005570","Total",3487,2544,1811,733,11,295,46,249,576,505,8,62,1,61
"2011","North Norfolk 002","E02005571","Total",2858,1737,1336,401,12,531,119,412,458,393,23,29,13,120
"2011","North Norfolk 003","E02005572","Total",3723,2329,1630,699,18,502,75,427,822,772,6,40,4,52
"2011","North Norfolk 004","E02005573","Total",2734,1924,1503,421,7,456,91,365,284,245,17,16,6,63
"2011","North Norfolk 005","E02005574","Total",3013,2377,1576,801,14,206,37,169,352,317,4,28,3,64
"2011","North Norfolk 006","E02005575","Total",3103,2265,1512,753,14,341,39,302,419,366,15,29,9,64
"2011","North Norfolk 007","E02005576","Total",3020,2244,1500,744,20,353,62,291,364,329,4,27,4,39
"2011","North Norfolk 008","E02005577","Total",2570,1825,1090,735,12,286,63,223,387,346,6,32,3,60
"2011","North Norfolk 009","E02005578","Total",2573,1605,970,635,8,310,75,235,537,488,25,13,11,113
"2011","North Norfolk 010","E02005579","Total",5597,3854,2237,1617,39,903,156,747,730,664,8,51,7,71
"2011","North Norfolk 011","E02005580","Total",3484,2404,1447,957,6,582,119,463,416,374,8,31,3,76
"2011","North Norfolk 012","E02005581","Total",3095,2242,1240,1002,3,283,68,215,496,461,13,18,4,71
"2011","North Norfolk 013","E02005582","Total",2948,2070,1221,849,12,345,57,288,465,423,4,30,8,56
"2011","North Norfolk 014","E02005583","Total",3841,2873,2010,863,23,511,116,395,358,314,10,27,7,76
"2011","Norwich 001","E02005584","Total",4736,2251,895,1356,17,1575,1271,304,855,796,6,45,8,38
"2011","Norwich 002","E02005585","Total",4673,1542,551,991,51,2350,1977,373,695,647,2,40,6,35
"2011","Norwich 003","E02005586","Total",4866,2469,857,1612,34,788,697,91,1534,1428,5,95,6,41
"2011","Norwich 004","E02005587","Total",4219,2287,1176,1111,23,1590,1500,90,280,241,0,35,4,39
"2011","Norwich 005","E02005588","Total",4708,1906,726,1180,37,1921,1302,619,795,732,2,49,12,49
"2011","Norwich 006","E02005589","Total",4784,1852,817,1035,67,1997,1699,298,811,726,6,74,5,57
"2011","Norwich 007","E02005590","Total",5708,1485,729,756,25,2649,1808,841,1472,1369,11,80,12,77
"2011","Norwich 009","E02005592","Total",4096,2248,1059,1189,11,223,93,130,1574,1488,3,79,4,40
"2011","Norwich 010","E02005593","Total",2901,1076,633,443,66,1285,827,458,436,373,6,40,17,38
"2011","Norwich 011","E02005594","Total",5381,2364,1276,1088,47,1367,1107,260,1535,1434,8,88,5,68
"2011","Norwich 012","E02005595","Total",3933,2956,1871,1085,14,459,387,72,460,421,5,32,2,44
"2011","Norwich 013","E02005596","Total",4358,1841,863,978,7,1940,1691,249,517,460,2,49,6,53
"2011","Norwich 014","E02006907","Total",3076,1014,480,534,25,649,255,394,1343,1267,13,39,24,45
"2011","Norwich 015","E02006908","Total",2880,1151,530,621,9,909,608,301,782,740,0,39,3,29
"2011","South Norfolk 001","E02005597","Total",5457,3944,1943,2001,99,839,166,673,526,476,3,44,3,49
"2011","South Norfolk 002","E02005598","Total",3245,2577,1358,1219,35,238,55,183,349,321,10,16,2,46
"2011","South Norfolk 003","E02005599","Total",2507,1913,1012,901,15,277,74,203,271,249,4,18,0,31
"2011","South Norfolk 004","E02005600","Total",2294,1772,993,779,10,255,56,199,225,190,12,19,4,32
"2011","South Norfolk 005","E02005601","Total",2763,1839,1103,736,49,429,122,307,414,370,7,34,3,32
"2011","South Norfolk 006","E02005602","Total",4433,3515,1989,1526,13,399,91,308,432,379,9,39,5,74
"2011","South Norfolk 007","E02005603","Total",3520,2683,1304,1379,66,312,70,242,419,376,6,35,2,40
"2011","South Norfolk 008","E02005604","Total",3451,2626,1532,1094,14,411,102,309,319,289,6,21,3,81
"2011","South Norfolk 009","E02005605","Total",4173,3316,1673,1643,22,392,71,321,393,343,7,38,5,50
"2011","South Norfolk 010","E02005606","Total",2318,1801,1039,762,4,183,46,137,283,260,8,13,2,47
"2011","South Norfolk 011","E02005607","Total",4484,3466,1701,1765,58,463,108,355,411,350,6,48,7,86
"2011","South Norfolk 012","E02005608","Total",3092,2376,1405,971,6,322,101,221,311,269,11,28,3,77
"2011","South Norfolk 013","E02005609","Total",3156,2154,1287,867,79,464,97,367,411,363,9,34,5,48
"2011","South Norfolk 014","E02005610","Total",3321,2507,1401,1106,34,320,91,229,389,352,5,27,5,71
"2011","South Norfolk 015","E02005611","Total",4595,3066,1823,1243,33,661,190,471,763,691,3,54,15,72
"2011","Babergh 001","E02006227","Total",2738,1874,1189,685,20,451,330,121,309,275,10,16,8,84
"2011","Babergh 002","E02006228","Total",2438,1887,1031,856,2,213,138,75,297,264,6,23,4,39
"2011","Babergh 003","E02006229","Total",2571,1803,1042,761,23,373,256,117,332,300,6,22,4,40
"2011","Babergh 004","E02006230","Total",4392,2923,1659,1264,27,707,513,194,649,457,124,31,37,86
"2011","Babergh 005","E02006231","Total",3574,2662,1171,1491,9,376,121,255,491,416,31,28,16,36
"2011","Babergh 006","E02006232","Total",2406,1891,1045,846,2,247,155,92,212,182,3,20,7,54
"2011","Babergh 007","E02006233","Total",5174,3059,1675,1384,46,1035,744,291,962,875,7,59,21,72
"2011","Babergh 008","E02006234","Total",3564,2466,1117,1349,21,620,475,145,407,362,4,36,5,50
"2011","Babergh 009","E02006235","Total",3380,2647,1586,1061,8,302,206,96,343,292,19,25,7,80
"2011","Babergh 010","E02006236","Total",4168,3475,2058,1417,13,286,187,99,337,296,7,30,4,57
"2011","Babergh 011","E02006237","Total",3117,2294,1288,1006,7,302,218,84,375,303,32,30,10,139
"2011","Forest Heath 001","E02006238","Total",4278,2700,1463,1237,47,580,212,368,871,792,23,44,12,80
"2011","Forest Heath 002","E02006239","Total",2350,1364,732,632,1,205,70,135,619,491,61,25,42,161
"2011","Forest Heath 003","E02006240","Total",3337,1751,903,848,33,226,67,159,1077,889,91,34,63,250
"2011","Forest Heath 004","E02006241","Total",3755,2005,932,1073,38,810,286,524,828,791,7,21,9,74
"2011","Forest Heath 005","E02006242","Total",3251,1935,789,1146,75,327,91,236,813,763,21,20,9,101
"2011","Forest Heath 006","E02006243","Total",4024,2021,841,1180,136,833,282,551,904,813,35,49,7,130
"2011","Forest Heath 008","E02006826","Total",4381,2398,1247,1151,24,758,349,409,1083,993,30,53,7,118
"2011","Ipswich 001","E02006245","Total",3218,1926,1053,873,4,1057,967,90,181,159,1,16,5,50
"2011","Ipswich 002","E02006246","Total",3034,2560,1391,1169,6,183,124,59,257,229,3,22,3,28
"2011","Ipswich 003","E02006247","Total",3777,2104,743,1361,52,1002,625,377,579,542,1,31,5,40
"2011","Ipswich 004","E02006248","Total",3296,2304,1057,1247,5,623,492,131,319,295,2,22,0,45
"2011","Ipswich 005","E02006249","Total",3403,2271,1193,1078,10,213,132,81,868,836,3,25,4,41
"2011","Ipswich 006","E02006250","Total",4363,1793,630,1163,36,836,468,368,1657,1578,16,47,16,41
"2011","Ipswich 007","E02006251","Total",4501,1934,735,1199,46,641,221,420,1830,1756,12,50,12,50
"2011","Ipswich 008","E02006252","Total",3921,2497,1018,1479,22,417,101,316,948,885,9,46,8,37
"2011","Ipswich 009","E02006253","Total",3017,2548,1524,1024,8,100,47,53,329,305,2,17,5,32
"2011","Ipswich 010","E02006254","Total",3898,1564,580,984,44,1415,1040,375,828,777,3,37,11,47
"2011","Ipswich 011","E02006255","Total",3573,2035,867,1168,37,218,73,145,1257,1204,8,36,9,26
"2011","Ipswich 012","E02006256","Total",3920,1748,694,1054,41,1122,697,425,967,896,5,52,14,42
"2011","Ipswich 013","E02006257","Total",2993,1715,876,839,9,922,833,89,298,272,2,20,4,49
"2011","Ipswich 014","E02006258","Total",3570,1862,682,1180,25,1103,793,310,524,483,7,33,1,56
"2011","Ipswich 015","E02006259","Total",3226,1673,868,805,8,1298,455,843,210,185,1,19,5,37
"2011","Ipswich 016","E02006260","Total",3588,1933,812,1121,15,1221,1070,151,369,340,3,20,6,50
"2011","Mid Suffolk 001","E02006261","Total",3234,2414,1441,973,16,408,302,106,329,275,10,42,2,67
"2011","Mid Suffolk 002","E02006262","Total",3605,2825,1569,1256,23,312,222,90,383,332,20,26,5,62
"2011","Mid Suffolk 003","E02006263","Total",3090,2268,1347,921,19,360,310,50,359,287,37,28,7,84
"2011","Mid Suffolk 004","E02006264","Total",3325,2677,1323,1354,32,215,155,60,346,314,11,18,3,55
"2011","Mid Suffolk 005","E02006265","Total",2980,2280,1287,993,39,374,268,106,242,206,15,18,3,45
"2011","Mid Suffolk 006","E02006266","Total",3848,2843,1541,1302,61,644,435,209,239,210,5,14,10,61
"2011","Mid Suffolk 007","E02006267","Total",3371,2575,1369,1206,16,289,202,87,423,382,16,17,8,68
"2011","Mid Suffolk 008","E02006268","Total",2736,1619,911,708,18,861,634,227,189,170,1,12,6,49
"2011","Mid Suffolk 009","E02006269","Total",2811,2318,1102,1216,8,173,115,58,286,255,5,21,5,26
"2011","Mid Suffolk 010","E02006270","Total",4787,3533,1331,2202,67,281,174,107,865,788,4,64,9,41
"2011","Mid Suffolk 011","E02006271","Total",3381,2405,1312,1093,29,333,219,114,568,325,145,23,75,46
"2011","Mid Suffolk 012","E02006272","Total",3138,2505,1343,1162,15,294,244,50,286,260,5,21,0,38
"2011","St Edmundsbury 001","E02006273","Total",2695,2039,1183,856,12,327,123,204,267,177,36,25,29,50
"2011","St Edmundsbury 002","E02006274","Total",2527,1416,731,685,8,328,118,210,709,404,174,19,112,66
"2011","St Edmundsbury 003","E02006275","Total",2956,1446,604,842,15,1207,599,608,246,207,0,30,9,42
"2011","St Edmundsbury 004","E02006276","Total",2730,2100,1274,826,32,304,104,200,243,212,11,14,6,51
"2011","St Edmundsbury 005","E02006277","Total",3148,2245,755,1490,63,161,12,149,665,625,2,32,6,14
"2011","St Edmundsbury 006","E02006278","Total",4184,2095,1144,951,59,640,158,482,1344,1272,9,53,10,46
"2011","St Edmundsbury 007","E02006279","Total",3965,2841,1655,1186,14,585,251,334,473,417,11,36,9,52
"2011","St Edmundsbury 008","E02006280","Total",3776,2885,1650,1235,12,394,141,253,389,334,30,20,5,96
"2011","St Edmundsbury 009","E02006281","Total",3916,2719,1682,1037,33,580,137,443,542,493,15,28,6,42
"2011","St Edmundsbury 010","E02006282","Total",2722,1977,1191,786,12,354,129,225,325,294,9,19,3,54
"2011","St Edmundsbury 011","E02006283","Total",2543,1977,1039,938,8,175,63,112,297,266,8,18,5,86
"2011","St Edmundsbury 012","E02006284","Total",3176,2048,877,1171,42,721,315,406,327,292,1,27,7,38
"2011","St Edmundsbury 013","E02006285","Total",3011,2054,577,1477,25,597,273,324,325,305,2,18,0,10
"2011","St Edmundsbury 014","E02006286","Total",4453,2784,1075,1709,41,948,385,563,646,594,7,36,9,34
"2011","Suffolk Coastal 001","E02006287","Total",2721,2086,1497,589,15,245,26,219,307,260,14,29,4,68
"2011","Suffolk Coastal 002","E02006288","Total",3673,2613,1593,1020,23,402,35,367,529,479,20,28,2,106
"2011","Suffolk Coastal 003","E02006289","Total",3670,2527,1549,978,40,631,54,577,411,369,12,24,6,61
"2011","Suffolk Coastal 004","E02006290","Total",3859,2525,1670,855,10,681,70,611,569,506,18,35,10,74
"2011","Suffolk Coastal 005","E02006291","Total",3118,2267,1420,847,16,467,34,433,324,297,3,19,5,44
"2011","Suffolk Coastal 006","E02006292","Total",2694,2150,1306,844,16,262,14,248,221,196,6,13,6,45
"2011","Suffolk Coastal 007","E02006293","Total",4089,2776,1400,1376,23,333,11,322,867,650,123,32,62,90
"2011","Suffolk Coastal 008","E02006294","Total",3792,2632,1772,860,17,582,35,547,497,449,11,29,8,64
"2011","Suffolk Coastal 009","E02006295","Total",3942,3207,1762,1445,6,307,17,290,392,365,1,22,4,30
"2011","Suffolk Coastal 010","E02006296","Total",5135,4112,1979,2133,15,175,14,161,795,752,6,35,2,38
"2011","Suffolk Coastal 011","E02006297","Total",3193,2839,1525,1314,11,43,2,41,267,246,12,7,2,33
"2011","Suffolk Coastal 012","E02006298","Total",3764,2902,1425,1477,15,315,27,288,506,458,10,29,9,26
"2011","Suffolk Coastal 013","E02006299","Total",3770,3258,2147,1111,9,155,15,140,313,284,5,22,2,35
"2011","Suffolk Coastal 014","E02006300","Total",3477,1750,850,900,4,1150,140,1010,518,481,8,27,2,55
"2011","Suffolk Coastal 015","E02006301","Total",2661,1549,879,670,14,318,27,291,751,695,12,33,11,29
"2011","Waveney 001","E02006302","Total",2895,2345,1471,874,14,164,124,40,337,300,9,23,5,35
"2011","Waveney 002","E02006303","Total",3191,1551,676,875,5,1286,1028,258,299,257,0,39,3,50
"2011","Waveney 003","E02006304","Total",3306,2613,1660,953,11,407,92,315,244,212,2,28,2,31
"2011","Waveney 004","E02006305","Total",4079,2248,1055,1193,11,382,87,295,1405,1330,2,64,9,33
"2011","Waveney 005","E02006306","Total",3203,2353,1348,1005,9,416,299,117,397,351,1,39,6,28
"2011","Waveney 006","E02006307","Total",3172,2854,1805,1049,5,52,35,17,241,213,2,24,2,20
"2011","Waveney 007","E02006308","Total",3496,1514,727,787,12,685,292,393,1247,1189,6,44,8,38
"2011","Waveney 008","E02006309","Total",2989,1871,1097,774,8,816,405,411,253,224,4,24,1,41
"2011","Waveney 009","E02006310","Total",3290,2532,1102,1430,12,278,86,192,434,396,3,35,0,34
"2011","Waveney 010","E02006311","Total",3828,2370,1529,841,43,694,420,274,660,610,2,46,2,61
"2011","Waveney 011","E02006312","Total",3649,2887,1652,1235,7,314,179,135,399,364,5,26,4,42
"2011","Waveney 012","E02006313","Total",4520,3565,2068,1497,24,359,179,180,513,448,22,38,5,59
"2011","Waveney 013","E02006314","Total",3190,2244,1320,924,18,435,328,107,437,384,12,37,4,56
"2011","Waveney 014","E02006315","Total",2828,2024,1447,577,27,393,295,98,316,279,12,21,4,68
"2011","Waveney 015","E02006316","Total",3247,2319,1546,773,9,467,385,82,396,363,7,23,3,56
"2011","Camden 001","E02000166","Total",3537,1595,895,700,29,1272,1118,154,571,514,9,37,11,70
"2011","Camden 002","E02000167","Total",3629,2017,1347,670,8,304,238,66,1211,1152,14,38,7,89
"2011","Camden 003","E02000168","Total",3535,1485,744,741,28,1034,577,457,943,900,10,26,7,45
"2011","Camden 004","E02000169","Total",2942,1631,1017,614,5,219,170,49,1001,973,3,18,7,86
"2011","Camden 005","E02000170","Total",3685,1643,781,862,24,416,234,182,1554,1504,4,35,11,48
"2011","Camden 006","E02000171","Total",3502,1517,772,745,31,906,614,292,991,938,7,34,12,57
"2011","Camden 007","E02000172","Total",4186,911,404,507,64,2465,2019,446,695,658,4,28,5,51
"2011","Camden 008","E02000173","Total",3569,1411,875,536,12,523,289,234,1539,1480,18,22,19,84
"2011","Camden 009","E02000174","Total",3822,1175,525,650,21,1581,1295,286,990,933,7,36,14,55
"2011","Camden 010","E02000175","Total",4277,1393,649,744,19,870,444,426,1937,1888,2,43,4,58
"2011","Camden 011","E02000176","Total",3261,1493,873,620,9,286,114,172,1411,1369,6,28,8,62
"2011","Camden 012","E02000177","Total",3865,1013,477,536,22,1898,1736,162,894,841,4,42,7,38
"2011","Camden 013","E02000178","Total",4280,1153,432,721,25,1401,931,470,1657,1608,2,33,14,44
"2011","Camden 014","E02000179","Total",2870,1049,612,437,6,916,815,101,861,821,14,20,6,38
"2011","Camden 015","E02000180","Total",3394,986,441,545,16,1298,903,395,1054,972,6,55,21,40
"2011","Camden 016","E02000181","Total",3657,1554,742,812,9,562,320,242,1490,1428,10,39,13,42
"2011","Camden 017","E02000182","Total",2963,1133,699,434,13,543,413,130,1158,1111,11,24,12,116
"2011","Camden 018","E02000183","Total",3881,1515,890,625,20,1130,476,654,1153,1047,38,49,19,63
"2011","Camden 019","E02000184","Total",3655,740,313,427,124,1674,1350,324,1086,1018,0,53,15,31
"2011","Camden 020","E02000185","Total",3938,815,367,448,65,1790,1295,495,1208,1149,6,32,21,60
"2011","Camden 021","E02000186","Total",3099,860,497,363,25,865,519,346,1272,1175,23,32,42,77
"2011","Camden 022","E02000187","Total",3290,396,168,228,12,2288,1583,705,541,505,3,23,10,53
"2011","Camden 023","E02000188","Total",3170,435,217,218,19,1957,1382,575,719,672,1,35,11,40
"2011","Camden 024","E02000189","Total",2253,285,145,140,12,1259,612,647,636,595,0,15,26,61
"2011","Camden 025","E02000190","Total",3181,664,395,269,6,1391,996,395,1038,967,8,39,24,82
"2011","Camden 026","E02000191","Total",2868,715,432,283,12,663,399,264,1387,1261,29,52,45,91
"2011","Camden 027","E02000192","Total",3375,676,316,360,6,1708,1132,576,918,856,10,36,16,67
"2011","Camden 028","E02000193","Total",3850,1108,619,489,32,1076,499,577,1519,1371,33,57,58,115
"2011","City of London 001","E02000001","Total",4385,1855,1093,762,13,725,458,267,1573,1451,16,61,45,219
"2011","Hackney 001","E02000345","Total",2693,748,387,361,110,636,272,364,1162,1117,0,40,5,37
"2011","Hackney 002","E02000346","Total",2563,290,116,174,45,1722,1436,286,475,459,2,7,7,31
"2011","Hackney 003","E02000347","Total",2727,744,326,418,18,1016,579,437,923,873,0,37,13,26
"2011","Hackney 004","E02000348","Total",2804,552,247,305,31,1325,563,762,851,816,2,27,6,45
"2011","Hackney 006","E02000350","Total",3605,1173,454,719,77,869,271,598,1447,1387,3,50,7,39
"2011","Hackney 007","E02000351","Total",3826,1123,391,732,83,908,312,596,1664,1593,5,64,2,48
"2011","Hackney 008","E02000352","Total",2810,887,304,583,89,1115,549,566,688,650,1,25,12,31
"2011","Hackney 009","E02000353","Total",3192,1323,499,824,13,692,347,345,1135,1097,6,26,6,29
"2011","Hackney 010","E02000354","Total",4056,866,242,624,114,1910,1106,804,1125,1061,10,41,13,41
"2011","Hackney 011","E02000355","Total",3240,1241,551,690,49,811,373,438,1101,1044,3,38,16,38
"2011","Hackney 012","E02000356","Total",3144,1270,451,819,53,861,469,392,935,889,2,30,14,25
"2011","Hackney 013","E02000357","Total",2507,353,109,244,10,1791,866,925,317,300,1,11,5,36
"2011","Hackney 014","E02000358","Total",4775,1287,432,855,85,1890,1068,822,1463,1406,2,34,21,50
"2011","Hackney 015","E02000359","Total",2416,968,376,592,29,799,424,375,582,557,2,16,7,38
"2011","Hackney 016","E02000360","Total",4747,725,196,529,85,2877,812,2065,988,937,1,29,21,72
"2011","Hackney 017","E02000361","Total",3467,703,229,474,48,1373,636,737,1310,1269,5,30,6,33
"2011","Hackney 018","E02000362","Total",2634,600,181,419,165,1183,558,625,655,630,1,21,3,31
"2011","Hackney 019","E02000363","Total",4402,636,190,446,126,2975,2157,818,610,576,1,20,13,55
"2011","Hackney 020","E02000364","Total",3899,1209,456,753,75,1518,606,912,1054,994,1,51,8,43
"2011","Hackney 021","E02000365","Total",5740,1478,544,934,100,1919,848,1071,2166,2091,7,60,8,77
"2011","Hackney 022","E02000366","Total",3690,830,283,547,54,2118,731,1387,623,580,0,24,19,65
"2011","Hackney 023","E02000367","Total",4163,1028,283,745,191,1604,610,994,1297,1237,6,47,7,43
"2011","Hackney 024","E02000368","Total",4028,743,209,534,28,2502,1946,556,700,656,3,27,14,55
"2011","Hackney 025","E02000369","Total",5100,757,247,510,317,2712,1762,950,1238,1191,1,34,12,76
"2011","Hackney 026","E02000370","Total",3768,660,232,428,158,2077,1705,372,828,774,3,37,14,45
"2011","Hackney 027","E02000371","Total",5672,916,282,634,98,2250,1767,483,2329,2228,8,60,33,79
"2011","Hackney 028","E02006918","Total",3113,575,177,398,93,1438,629,809,985,937,1,38,9,22
"2011","Hackney 029","E02006921","Total",2909,494,203,291,30,1539,761,778,798,763,2,23,10,48
"2011","Hammersmith and Fulham 001","E02000372","Total",3674,745,354,391,159,2054,495,1559,673,630,2,23,18,43
"2011","Hammersmith and Fulham 002","E02000373","Total",2433,343,128,215,15,1691,1535,156,336,318,4,8,6,48
"2011","Hammersmith and Fulham 003","E02000374","Total",2590,963,451,512,52,935,343,592,599,565,0,24,10,41
"2011","Hammersmith and Fulham 004","E02000375","Total",3230,777,365,412,52,1438,853,585,922,886,5,26,5,41
"2011","Hammersmith and Fulham 005","E02000376","Total",3152,771,320,451,58,1053,378,675,1221,1185,1,26,9,49
"2011","Hammersmith and Fulham 006","E02000377","Total",3613,1093,432,661,90,1262,485,777,1126,1091,4,24,7,42
"2011","Hammersmith and Fulham 007","E02000378","Total",3271,1128,448,680,17,843,490,353,1251,1195,5,42,9,32
"2011","Hammersmith and Fulham 008","E02000379","Total",3190,1333,605,728,97,869,319,550,864,813,1,40,10,27
"2011","Hammersmith and Fulham 009","E02000380","Total",2559,1098,538,560,9,633,175,458,787,750,5,28,4,32
"2011","Hammersmith and Fulham 010","E02000381","Total",3583,1337,672,665,16,891,311,580,1294,1227,9,52,6,45
"2011","Hammersmith and Fulham 011","E02000382","Total",2823,1039,540,499,73,701,270,431,970,912,11,34,13,40
"2011","Hammersmith and Fulham 012","E02000383","Total",4456,1496,719,777,28,911,428,483,1942,1837,11,60,34,79
"2011","Hammersmith and Fulham 013","E02000384","Total",3256,709,346,363,37,1515,777,738,930,885,7,33,5,65
"2011","Hammersmith and Fulham 014","E02000385","Total",3094,1089,440,649,21,498,217,281,1440,1350,8,62,20,46
"2011","Hammersmith and Fulham 015","E02000386","Total",3585,784,292,492,37,1625,1242,383,1058,1007,8,27,16,81
"2011","Hammersmith and Fulham 016","E02000387","Total",2841,747,309,438,15,1298,690,608,743,680,11,35,17,38
"2011","Hammersmith and Fulham 017","E02000388","Total",3805,1138,531,607,56,1172,441,731,1385,1310,5,54,16,54
"2011","Hammersmith and Fulham 018","E02000389","Total",3452,1745,824,921,38,517,361,156,1081,1029,1,39,12,71
"2011","Hammersmith and Fulham 019","E02000390","Total",2823,1072,510,562,16,746,351,395,954,906,3,36,9,35
"2011","Hammersmith and Fulham 020","E02000391","Total",3419,1493,775,718,19,841,456,385,1012,947,11,46,8,54
"2011","Hammersmith and Fulham 021","E02000392","Total",4122,1496,690,806,88,1041,793,248,1440,1360,8,62,10,57
"2011","Hammersmith and Fulham 022","E02000393","Total",2650,1311,592,719,18,339,144,195,947,910,0,35,2,35
"2011","Hammersmith and Fulham 023","E02000394","Total",3551,1159,532,627,145,1218,498,720,951,880,5,59,7,78
"2011","Hammersmith and Fulham 024","E02000395","Total",2719,1425,828,597,27,279,147,132,921,879,5,34,3,67
"2011","Hammersmith and Fulham 025","E02000396","Total",2699,1106,536,570,74,763,484,279,708,663,2,40,3,48
"2011","Haringey 001","E02000397","Total",3376,1166,454,712,50,849,411,438,1262,1221,2,30,9,49
"2011","Haringey 002","E02000398","Total",2713,664,309,355,22,1332,1003,329,656,631,3,15,7,39
"2011","Haringey 004","E02000400","Total",3061,1300,551,749,87,901,527,374,737,714,1,16,6,36
"2011","Haringey 005","E02000401","Total",2351,780,263,517,22,1178,935,243,337,312,3,13,9,34
"2011","Haringey 006","E02000402","Total",2469,652,207,445,46,1169,867,302,551,520,0,12,19,51
"2011","Haringey 007","E02000403","Total",2915,1109,424,685,15,451,215,236,1305,1274,3,20,8,35
"2011","Haringey 008","E02000404","Total",2640,984,417,567,55,838,645,193,716,688,1,18,9,47
"2011","Haringey 009","E02000405","Total",2550,1744,722,1022,7,208,134,74,573,557,1,14,1,18
"2011","Haringey 010","E02000406","Total",2665,869,339,530,17,1049,979,70,686,662,1,16,7,44
"2011","Haringey 011","E02000407","Total",2905,817,309,508,67,1033,430,603,914,877,2,24,11,74
"2011","Haringey 012","E02000408","Total",2689,688,246,442,47,1198,789,409,703,662,0,18,23,53
"2011","Haringey 013","E02000409","Total",2505,651,295,356,11,1331,1006,325,459,430,1,16,12,53
"2011","Haringey 014","E02000410","Total",2839,1548,630,918,6,186,75,111,1082,1041,12,25,4,17
"2011","Haringey 015","E02000411","Total",2695,990,383,607,29,911,622,289,713,674,6,22,11,52
"2011","Haringey 016","E02000412","Total",2873,692,322,370,134,1065,575,490,934,912,2,14,6,48
"2011","Haringey 017","E02000413","Total",2945,1645,748,897,49,428,329,99,794,760,1,23,10,29
"2011","Haringey 018","E02000414","Total",2562,1144,479,665,26,510,218,292,844,821,0,15,8,38
"2011","Haringey 019","E02000415","Total",2697,1102,537,565,24,543,278,265,982,946,2,18,16,46
"2011","Haringey 020","E02000416","Total",3463,1170,356,814,78,1202,857,345,974,946,2,22,4,39
"2011","Haringey 021","E02000417","Total",2852,1500,719,781,7,234,132,102,1078,1027,8,35,8,33
"2011","Haringey 022","E02000418","Total",2235,1524,658,866,19,255,226,29,416,395,2,13,6,21
"2011","Haringey 023","E02000419","Total",3323,1214,504,710,16,506,223,283,1527,1493,5,15,14,60
"2011","Haringey 024","E02000420","Total",3050,951,351,600,21,1059,516,543,969,935,2,16,16,50
"2011","Haringey 025","E02000421","Total",2875,638,222,416,122,1266,741,525,810,773,0,23,14,39
"2011","Haringey 026","E02000422","Total",2926,966,388,578,75,916,648,268,914,883,7,21,3,55
"2011","Haringey 027","E02000423","Total",2516,1083,510,573,13,370,242,128,1024,988,4,16,16,26
"2011","Haringey 028","E02000424","Total",3088,1438,488,950,36,749,289,460,837,805,0,22,10,28
"2011","Haringey 029","E02000425","Total",2116,775,389,386,60,457,278,179,808,767,1,28,12,16
"2011","Haringey 030","E02000426","Total",2882,1517,786,731,12,462,315,147,826,769,22,25,10,65
"2011","Haringey 031","E02000427","Total",2829,1084,432,652,67,379,171,208,1268,1234,3,27,4,31
"2011","Haringey 032","E02000428","Total",2758,748,287,461,43,1184,930,254,728,708,2,13,5,55
"2011","Haringey 033","E02000429","Total",3207,1810,828,982,21,298,118,180,1054,1020,2,29,3,24
"2011","Haringey 034","E02000430","Total",3462,1524,542,982,45,412,142,270,1442,1404,4,32,2,39
"2011","Haringey 035","E02000431","Total",3133,1502,691,811,6,184,75,109,1407,1374,2,28,3,34
"2011","Haringey 036","E02000432","Total",2879,1121,357,764,13,728,426,302,986,956,1,27,2,31
"2011","Haringey 037","E02006794","Total",2911,493,183,310,165,1401,921,480,779,745,1,16,17,73
"2011","Islington 001","E02000554","Total",4226,1010,319,691,29,2285,1737,548,860,815,2,32,11,42
"2011","Islington 002","E02000555","Total",3986,1458,553,905,43,1495,1034,461,941,894,4,37,6,49
"2011","Islington 003","E02000556","Total",4561,1387,499,888,48,1639,1006,633,1435,1395,4,28,8,52
"2011","Islington 004","E02000557","Total",3929,1007,382,625,57,1868,990,878,950,908,6,29,7,47
"2011","Islington 005","E02000558","Total",3780,513,201,312,23,2421,1751,670,772,741,4,22,5,51
"2011","Islington 006","E02000559","Total",3882,1440,599,841,66,963,496,467,1377,1321,3,49,4,36
"2011","Islington 007","E02000560","Total",3177,1034,389,645,24,812,434,378,1257,1207,2,40,8,50
"2011","Islington 008","E02000561","Total",3413,1533,647,886,25,850,276,574,966,915,3,33,15,39
"2011","Islington 009","E02000562","Total",3594,1246,488,758,12,1481,1143,338,807,766,2,31,8,48
"2011","Islington 010","E02000563","Total",3652,830,287,543,37,1855,1367,488,871,813,3,29,26,59
"2011","Islington 011","E02000564","Total",5004,1162,393,769,240,1809,993,816,1724,1653,2,57,12,69
"2011","Islington 012","E02000565","Total",3610,897,267,630,49,1817,1382,435,795,759,2,25,9,52
"2011","Islington 013","E02000566","Total",3662,1484,675,809,27,1061,557,504,1049,1001,4,36,8,41
"2011","Islington 014","E02000567","Total",4937,1446,486,960,57,2122,1573,549,1269,1213,4,45,7,43
"2011","Islington 015","E02000568","Total",4063,736,285,451,133,2177,1115,1062,961,882,7,28,44,56
"2011","Islington 016","E02000569","Total",4745,1241,586,655,57,2354,1530,824,1015,939,12,54,10,78
"2011","Islington 017","E02000570","Total",4119,1715,804,911,9,1071,543,528,1283,1235,5,37,6,41
"2011","Islington 018","E02000571","Total",3777,1000,354,646,40,1947,1365,582,734,679,6,40,9,56
"2011","Islington 019","E02000572","Total",3490,513,201,312,61,2135,920,1215,729,695,1,20,13,52
"2011","Islington 020","E02000573","Total",4204,1580,783,797,29,1201,699,502,1327,1280,4,36,7,67
"2011","Islington 021","E02000574","Total",3840,1004,414,590,68,1432,893,539,1289,1231,3,43,12,47
"2011","Islington 022","E02000575","Total",5583,1570,669,901,34,2060,1592,468,1830,1702,12,66,50,89
"2011","Islington 023","E02000576","Total",4322,758,306,452,39,2487,1618,869,976,910,4,35,27,62
"2011","Kensington and Chelsea 001","E02000577","Total",3163,330,127,203,60,2344,1421,923,396,365,2,14,15,33
"2011","Kensington and Chelsea 002","E02000578","Total",2454,310,135,175,81,1778,469,1309,238,215,0,11,12,47
"2011","Kensington and Chelsea 003","E02000579","Total",4013,1316,685,631,86,1700,522,1178,859,817,3,31,8,52
"2011","Kensington and Chelsea 004","E02000580","Total",4517,941,506,435,50,2275,547,1728,1212,1151,9,41,11,39
"2011","Kensington and Chelsea 005","E02000581","Total",3311,413,218,195,60,2383,1364,1019,401,372,4,13,12,54
"2011","Kensington and Chelsea 006","E02000582","Total",3946,1601,1053,548,44,502,111,391,1698,1572,50,50,26,101
"2011","Kensington and Chelsea 007","E02000583","Total",3496,1590,1041,549,21,648,97,551,1166,1102,13,40,11,71
"2011","Kensington and Chelsea 008","E02000584","Total",3922,1870,1314,556,14,276,166,110,1559,1472,29,34,24,203
"2011","Kensington and Chelsea 009","E02000585","Total",3919,1757,1093,664,36,522,125,397,1469,1404,9,40,16,135
"2011","Kensington and Chelsea 010","E02000586","Total",3729,1587,1086,501,19,148,15,133,1765,1689,22,30,24,210
"2011","Kensington and Chelsea 011","E02000587","Total",3536,1695,1174,521,12,130,21,109,1592,1527,14,29,22,107
"2011","Kensington and Chelsea 012","E02000588","Total",4458,1647,1172,475,18,144,2,142,2298,2202,20,46,30,351
"2011","Kensington and Chelsea 013","E02000589","Total",4422,1529,941,588,25,465,90,375,2258,2163,17,54,24,145
"2011","Kensington and Chelsea 014","E02000590","Total",3890,1147,847,300,10,1174,345,829,1436,1356,11,23,46,123
"2011","Kensington and Chelsea 015","E02000591","Total",3589,1012,585,427,50,1032,114,918,1417,1369,7,23,18,78
"2011","Kensington and Chelsea 016","E02000592","Total",3583,1494,1024,470,11,181,11,170,1763,1673,36,31,23,134
"2011","Kensington and Chelsea 017","E02000593","Total",4067,1601,834,767,37,624,125,499,1712,1628,13,58,13,93
"2011","Kensington and Chelsea 018","E02000594","Total",3710,1681,1188,493,17,505,126,379,1329,1241,30,45,13,178
"2011","Kensington and Chelsea 019","E02000595","Total",3747,1763,1243,520,13,545,397,148,1297,1225,14,42,16,129
"2011","Kensington and Chelsea 020","E02000596","Total",3605,1686,1075,611,13,336,158,178,1468,1402,8,39,19,102
"2011","Kensington and Chelsea 021","E02000597","Total",3459,1037,592,445,23,1559,975,584,775,731,7,30,7,65
"2011","Lambeth 002","E02000619","Total",3743,960,378,582,56,2015,1584,431,664,617,6,29,12,48
"2011","Lambeth 003","E02000620","Total",4398,1141,420,721,219,1932,1215,717,1058,979,19,42,18,48
"2011","Lambeth 004","E02000621","Total",5083,1370,523,847,225,1619,576,1043,1794,1670,36,67,21,75
"2011","Lambeth 005","E02000622","Total",3482,1014,357,657,21,1282,719,563,1132,1076,4,36,16,33
"2011","Lambeth 006","E02000623","Total",3409,756,274,482,24,1851,1029,822,736,694,2,32,8,42
"2011","Lambeth 007","E02000624","Total",3500,783,207,576,21,1826,1093,733,843,785,1,45,12,27
"2011","Lambeth 008","E02000625","Total",3383,693,191,502,49,1769,1090,679,839,796,2,27,14,33
"2011","Lambeth 009","E02000626","Total",3443,562,124,438,41,2280,1875,405,521,471,3,38,9,39
"2011","Lambeth 010","E02000627","Total",4042,1000,350,650,121,1673,544,1129,1197,1130,6,48,13,51
"2011","Lambeth 011","E02000628","Total",3972,647,156,491,40,2353,1347,1006,881,794,5,63,19,51
"2011","Lambeth 012","E02000629","Total",3973,1276,404,872,63,1133,701,432,1454,1391,4,49,10,47
"2011","Lambeth 013","E02000630","Total",3336,1257,507,750,49,846,660,186,1144,1077,12,45,10,40
"2011","Lambeth 014","E02000631","Total",3723,1480,556,924,14,1037,231,806,1148,1078,11,45,14,44
"2011","Lambeth 015","E02000632","Total",4148,1401,434,967,44,907,298,609,1765,1683,5,62,15,31
"2011","Lambeth 016","E02000633","Total",3872,922,298,624,107,1758,931,827,1023,961,0,41,21,62
"2011","Lambeth 017","E02000634","Total",3021,761,270,491,42,1321,1040,281,866,826,3,31,6,31
"2011","Lambeth 018","E02000635","Total",4066,1202,406,796,81,1573,536,1037,1161,1101,1,40,19,49
"2011","Lambeth 019","E02000636","Total",3076,1612,655,957,18,426,287,139,1004,964,2,32,6,16
"2011","Lambeth 020","E02000637","Total",3935,1569,548,1021,33,840,325,515,1456,1385,5,50,16,37
"2011","Lambeth 021","E02000638","Total",4104,1249,363,886,115,1588,1118,470,1116,1049,7,44,16,36
"2011","Lambeth 022","E02000639","Total",3398,757,257,500,28,1731,652,1079,844,787,3,21,33,38
"2011","Lambeth 023","E02000640","Total",3785,1806,621,1185,16,972,522,450,958,907,1,40,10,33
"2011","Lambeth 024","E02000641","Total",3442,766,207,559,52,2013,1093,920,582,554,3,17,8,29
"2011","Lambeth 025","E02000642","Total",4162,1651,621,1030,47,1342,440,902,1091,1037,0,48,6,31
"2011","Lambeth 026","E02000643","Total",3589,1456,470,986,38,925,674,251,1139,1083,3,45,8,31
"2011","Lambeth 027","E02000644","Total",3565,1627,533,1094,26,725,366,359,1144,1092,6,38,8,43
"2011","Lambeth 028","E02000645","Total",3870,1646,510,1136,31,788,412,376,1371,1303,4,52,12,34
"2011","Lambeth 029","E02000646","Total",3842,1710,648,1062,13,492,212,280,1587,1524,5,44,14,40
"2011","Lambeth 030","E02000647","Total",3444,1843,675,1168,64,664,436,228,837,810,0,18,9,36
"2011","Lambeth 031","E02000648","Total",3232,1025,300,725,63,1592,1212,380,527,486,3,21,17,25
"2011","Lambeth 032","E02000649","Total",4887,1842,525,1317,47,732,418,314,2223,2165,5,47,6,43
"2011","Lambeth 033","E02000650","Total",3233,1167,310,857,22,1206,886,320,803,757,5,31,10,35
"2011","Lambeth 034","E02000651","Total",3492,1630,618,1012,57,574,294,280,1199,1174,1,16,8,32
"2011","Lambeth 035","E02000652","Total",2527,1471,668,803,40,386,112,274,608,573,0,23,12,22
"2011","Lambeth 036","E02006801","Total",3840,833,394,439,60,1448,568,880,1418,1244,75,62,37,81
"2011","Lewisham 001","E02000653","Total",3547,630,174,456,168,1881,1062,819,827,795,1,18,13,41
"2011","Lewisham 002","E02000654","Total",3336,518,141,377,74,2062,1546,516,643,613,3,19,8,39
"2011","Lewisham 003","E02000655","Total",3366,987,227,760,72,1144,833,311,1140,1094,5,36,5,23
"2011","Lewisham 005","E02000657","Total",3776,1069,379,690,53,1305,651,654,1310,1249,4,44,13,39
"2011","Lewisham 006","E02000658","Total",3538,1128,411,717,40,1215,703,512,1110,1069,2,26,13,45
"2011","Lewisham 007","E02000659","Total",3284,1314,506,808,10,1194,918,276,737,696,4,33,4,29
"2011","Lewisham 008","E02000660","Total",3659,1273,372,901,66,932,599,333,1347,1257,8,75,7,41
"2011","Lewisham 009","E02000661","Total",3139,1460,662,798,6,656,465,191,996,963,5,24,4,21
"2011","Lewisham 010","E02000662","Total",3317,1041,285,756,68,1293,930,363,889,816,0,62,11,26
"2011","Lewisham 011","E02000663","Total",2903,1430,509,921,10,711,287,424,731,659,3,62,7,21
"2011","Lewisham 012","E02000664","Total",4452,1208,423,785,171,1547,728,819,1475,1427,4,28,16,51
"2011","Lewisham 013","E02000665","Total",3504,1672,604,1068,41,870,385,485,897,852,3,31,11,24
"2011","Lewisham 014","E02000666","Total",2859,1409,483,926,15,651,284,367,720,677,3,35,5,64
"2011","Lewisham 015","E02000667","Total",2595,1604,594,1010,39,327,114,213,606,574,1,27,4,19
"2011","Lewisham 016","E02000668","Total",2816,1721,757,964,19,472,176,296,583,545,2,33,3,21
"2011","Lewisham 017","E02000669","Total",3270,1502,421,1081,47,569,148,421,1127,1082,0,37,8,25
"2011","Lewisham 018","E02000670","Total",2748,1178,420,758,7,771,170,601,762,738,1,17,6,30
"2011","Lewisham 019","E02000671","Total",3668,1842,596,1246,53,728,283,445,1009,959,5,35,10,36
"2011","Lewisham 020","E02000672","Total",3509,1417,502,915,18,912,425,487,1131,1069,5,37,20,31
"2011","Lewisham 021","E02000673","Total",3490,1849,704,1145,17,655,313,342,939,895,7,28,9,30
"2011","Lewisham 022","E02000674","Total",3020,2031,677,1354,19,378,102,276,562,513,0,38,11,30
"2011","Lewisham 023","E02000675","Total",3419,2121,835,1286,21,639,108,531,602,570,1,29,2,36
"2011","Lewisham 024","E02000676","Total",3252,1709,529,1180,20,681,211,470,814,765,2,38,9,28
"2011","Lewisham 025","E02000677","Total",2692,1726,624,1102,18,340,102,238,577,557,0,14,6,31
"2011","Lewisham 026","E02000678","Total",2432,1231,382,849,11,761,220,541,407,378,0,21,8,22
"2011","Lewisham 027","E02000679","Total",3455,1516,558,958,76,1099,784,315,729,693,1,29,6,35
"2011","Lewisham 028","E02000680","Total",3016,1235,464,771,29,1060,479,581,652,602,5,23,22,40
"2011","Lewisham 029","E02000681","Total",3268,1541,515,1026,37,1176,535,641,492,457,2,27,6,22
"2011","Lewisham 030","E02000682","Total",3095,1492,643,849,19,1145,409,736,404,372,1,24,7,35
"2011","Lewisham 031","E02000683","Total",2763,1186,452,734,45,1011,214,797,502,474,0,24,4,19
"2011","Lewisham 033","E02000685","Total",3357,1374,484,890,14,1278,684,594,649,608,0,30,11,42
"2011","Lewisham 034","E02000686","Total",2839,909,290,619,36,1513,674,839,356,321,1,24,10,25
"2011","Lewisham 035","E02000687","Total",3436,1541,554,987,23,1082,664,418,763,726,3,24,10,27
"2011","Lewisham 037","E02006783","Total",2893,1240,382,858,26,1216,412,804,394,360,1,23,10,17
"2011","Lewisham 038","E02006784","Total",3168,1439,513,926,24,1260,371,889,399,352,2,31,14,46
"2011","Lewisham 039","E02006798","Total",3210,685,201,484,24,1518,1095,423,935,888,4,33,10,48
"2011","Newham 001","E02000714","Total",2733,999,399,600,69,767,373,394,866,833,2,20,11,32
"2011","Newham 002","E02000715","Total",2234,761,305,456,10,612,482,130,816,791,0,15,10,35
"2011","Newham 003","E02000716","Total",2320,838,331,507,39,555,258,297,854,820,4,16,14,34
"2011","Newham 004","E02000717","Total",2400,842,334,508,37,568,349,219,921,881,2,28,10,32
"2011","Newham 005","E02000718","Total",2210,683,240,443,22,970,826,144,503,486,2,11,4,32
"2011","Newham 006","E02000719","Total",2937,814,333,481,65,922,428,494,1104,1074,2,18,10,32
"2011","Newham 007","E02000720","Total",2220,1057,471,586,21,339,124,215,776,733,1,29,13,27
"2011","Newham 008","E02000721","Total",2737,1000,481,519,27,531,251,280,1139,1083,3,29,24,40
"2011","Newham 009","E02000722","Total",2943,799,331,468,106,824,382,442,1189,1152,0,28,9,25
"2011","Newham 010","E02000723","Total",2737,1342,704,638,14,307,180,127,1039,982,9,31,17,35
"2011","Newham 011","E02000724","Total",2434,1180,531,649,19,273,158,115,932,888,3,29,12,30
"2011","Newham 012","E02000725","Total",3671,730,257,473,212,1207,598,609,1475,1422,2,23,28,47
"2011","Newham 013","E02000726","Total",3666,721,243,478,147,1128,787,341,1640,1600,3,27,10,30
"2011","Newham 014","E02000727","Total",2251,908,455,453,16,336,191,145,966,921,3,28,14,25
"2011","Newham 015","E02000728","Total",2237,1065,454,611,16,210,110,100,918,868,2,37,11,28
"2011","Newham 016","E02000729","Total",2207,879,421,458,31,473,121,352,794,742,5,30,17,30
"2011","Newham 017","E02000730","Total",2443,1073,563,510,10,353,83,270,978,927,4,32,15,29
"2011","Newham 018","E02000731","Total",2825,1141,502,639,7,387,200,187,1253,1193,8,37,15,37
"2011","Newham 019","E02000732","Total",2326,652,282,370,28,905,606,299,706,683,1,15,7,35
"2011","Newham 020","E02000733","Total",3465,908,280,628,41,1568,1293,275,907,875,4,23,5,41
"2011","Newham 021","E02000734","Total",2672,587,250,337,88,1327,864,463,621,587,3,20,11,49
"2011","Newham 022","E02000735","Total",2355,866,371,495,23,665,398,267,769,741,0,20,8,32
"2011","Newham 023","E02000736","Total",2574,996,308,688,19,780,632,148,750,709,0,30,11,29
"2011","Newham 024","E02000737","Total",3068,1420,524,896,21,830,674,156,764,728,0,27,9,33
"2011","Newham 025","E02000738","Total",2563,1406,517,889,20,271,148,123,840,795,2,35,8,26
"2011","Newham 026","E02000739","Total",2286,724,263,461,64,801,452,349,670,633,5,19,13,27
"2011","Newham 027","E02000740","Total",2556,582,170,412,19,1289,762,527,637,594,2,22,19,29
"2011","Newham 028","E02000741","Total",2767,1273,448,825,31,625,414,211,816,790,3,16,7,22
"2011","Newham 029","E02000742","Total",2498,1083,368,715,16,714,556,158,662,630,0,18,14,23
"2011","Newham 030","E02000743","Total",2893,681,240,441,34,1458,1180,278,678,631,4,24,19,42
"2011","Newham 031","E02000744","Total",2942,831,305,526,24,884,546,338,1168,1137,0,21,10,35
"2011","Newham 032","E02000745","Total",2782,923,260,663,49,990,470,520,790,762,1,18,9,30
"2011","Newham 033","E02000746","Total",2574,575,113,462,88,1161,251,910,721,664,3,13,41,29
"2011","Newham 034","E02000747","Total",4371,788,241,547,179,1613,1206,407,1737,1698,4,19,16,54
"2011","Newham 035","E02000748","Total",2230,890,250,640,22,498,229,269,793,764,1,18,10,27
"2011","Newham 036","E02000749","Total",3022,691,201,490,111,1607,1105,502,574,544,1,16,13,39
"2011","Newham 037","E02000750","Total",4370,1114,247,867,61,1344,905,439,1804,1757,9,29,9,47
"2011","Southwark 001","E02000807","Total",3705,1506,450,1056,135,714,241,473,1304,1234,8,45,17,46
"2011","Southwark 002","E02000808","Total",4167,996,352,644,139,1561,796,765,1386,1198,78,63,47,85
"2011","Southwark 003","E02000809","Total",5936,1969,647,1322,63,1142,930,212,2655,2537,6,86,26,107
"2011","Southwark 004","E02000810","Total",4137,905,266,639,259,2159,1649,510,769,710,6,45,8,45
"2011","Southwark 006","E02000812","Total",4385,909,241,668,109,2198,1590,608,1108,1012,19,65,12,61
"2011","Southwark 007","E02000813","Total",3746,764,228,536,79,2057,1645,412,798,753,6,32,7,48
"2011","Southwark 008","E02000814","Total",3876,1396,460,936,66,905,225,680,1458,1404,1,40,13,51
"2011","Southwark 009","E02000815","Total",2516,520,169,351,137,960,787,173,864,803,5,44,12,35
"2011","Southwark 010","E02000816","Total",3959,901,264,637,190,1934,1393,541,894,851,0,36,7,40
"2011","Southwark 011","E02000817","Total",2809,363,118,245,36,1993,1502,491,385,368,0,13,4,32
"2011","Southwark 012","E02000818","Total",3217,546,156,390,76,1635,1103,532,922,880,3,24,15,38
"2011","Southwark 013","E02000819","Total",3415,580,168,412,48,2055,1262,793,699,642,1,26,30,33
"2011","Southwark 014","E02000820","Total",3873,857,289,568,73,1959,1555,404,937,886,6,37,8,47
"2011","Southwark 015","E02000821","Total",3097,418,151,267,19,2103,1828,275,524,490,1,22,11,33
"2011","Southwark 016","E02000822","Total",3294,365,110,255,13,2338,1879,459,542,508,0,25,9,36
"2011","Southwark 017","E02000823","Total",3155,791,251,540,46,1600,1472,128,687,657,0,23,7,31
"2011","Southwark 018","E02000824","Total",3553,506,154,352,42,2504,2102,402,460,426,1,20,13,41
"2011","Southwark 019","E02000825","Total",3545,559,77,482,83,2329,1598,731,541,506,0,23,12,33
"2011","Southwark 020","E02000826","Total",3539,830,229,601,67,1950,1474,476,656,629,1,22,4,36
"2011","Southwark 021","E02000827","Total",4304,613,190,423,64,2764,1819,945,814,763,6,38,7,49
"2011","Southwark 022","E02000828","Total",3180,641,191,450,96,1793,1454,339,604,571,4,19,10,46
"2011","Southwark 023","E02000829","Total",4334,1160,342,818,92,2120,1496,624,914,850,2,40,22,48
"2011","Southwark 024","E02000830","Total",3783,1547,530,1017,51,1167,773,394,972,905,2,56,9,46
"2011","Southwark 025","E02000831","Total",3918,1518,509,1009,129,1270,674,596,948,890,1,39,18,53
"2011","Southwark 026","E02000832","Total",4106,1161,332,829,126,2066,1399,667,704,674,0,23,7,49
"2011","Southwark 027","E02000833","Total",2973,1009,337,672,25,1460,1335,125,445,403,5,29,8,34
"2011","Southwark 028","E02000834","Total",4198,1844,598,1246,38,974,332,642,1301,1255,3,35,8,41
"2011","Southwark 029","E02000835","Total",2930,1497,525,972,18,837,638,199,546,518,1,27,0,32
"2011","Southwark 030","E02000836","Total",3362,1924,660,1264,15,612,341,271,776,745,8,19,4,35
"2011","Southwark 031","E02000837","Total",3300,2247,1069,1178,2,413,291,122,601,556,17,19,9,37
"2011","Southwark 032","E02000838","Total",3862,1995,660,1335,30,874,422,452,931,887,3,31,10,32
"2011","Southwark 033","E02000839","Total",3381,1805,829,976,56,836,761,75,632,588,16,23,5,52
"2011","Southwark 034","E02006802","Total",2867,688,253,435,31,1362,862,500,716,653,2,43,18,70
"2011","Tower Hamlets 001","E02000864","Total",3468,646,242,404,69,1985,619,1366,742,707,0,24,11,26
"2011","Tower Hamlets 002","E02000865","Total",2763,478,168,310,61,1532,856,676,666,626,8,23,9,26
"2011","Tower Hamlets 003","E02000866","Total",3829,1307,540,767,53,1380,303,1077,1046,991,2,47,6,43
"2011","Tower Hamlets 004","E02000867","Total",4307,1120,302,818,173,1410,564,846,1548,1482,3,53,10,56
"2011","Tower Hamlets 005","E02000868","Total",2618,685,245,440,26,941,429,512,940,885,4,37,14,26
"2011","Tower Hamlets 006","E02000869","Total",2485,684,262,422,21,1165,764,401,592,547,3,29,13,23
"2011","Tower Hamlets 007","E02000870","Total",2560,678,251,427,50,1166,712,454,636,604,1,26,5,30
"2011","Tower Hamlets 008","E02000871","Total",3107,489,138,351,102,1730,489,1241,739,695,1,25,18,47
"2011","Tower Hamlets 009","E02000872","Total",3088,671,225,446,38,1253,911,342,1096,1046,2,35,13,30
"2011","Tower Hamlets 010","E02000873","Total",2792,661,224,437,66,1295,1018,277,746,579,2,25,140,24
"2011","Tower Hamlets 011","E02000874","Total",2494,463,164,299,26,1328,861,467,644,603,1,12,28,33
"2011","Tower Hamlets 012","E02000875","Total",3437,551,160,391,54,1857,670,1187,925,875,3,36,11,50
"2011","Tower Hamlets 013","E02000876","Total",2750,651,219,432,29,1029,567,462,1007,953,0,40,14,34
"2011","Tower Hamlets 014","E02000877","Total",3252,618,193,425,22,1749,574,1175,833,787,0,29,17,30
"2011","Tower Hamlets 015","E02000878","Total",3900,1002,377,625,50,1244,482,762,1559,1471,4,41,43,45
"2011","Tower Hamlets 016","E02000879","Total",2855,694,278,416,43,1314,541,773,755,691,4,37,23,49
"2011","Tower Hamlets 017","E02000880","Total",2090,504,167,337,33,908,704,204,621,586,3,18,14,24
"2011","Tower Hamlets 018","E02000881","Total",2379,520,197,323,104,1291,458,833,437,401,2,11,23,27
"2011","Tower Hamlets 019","E02000882","Total",2884,425,140,285,266,1785,721,1064,371,343,0,16,12,37
"2011","Tower Hamlets 020","E02000883","Total",2880,438,178,260,61,1731,553,1178,622,585,3,17,17,28
"2011","Tower Hamlets 021","E02000884","Total",3707,685,254,431,91,998,342,656,1893,1833,13,26,21,40
"2011","Tower Hamlets 022","E02000885","Total",2509,422,153,269,97,1421,501,920,535,504,0,15,16,34
"2011","Tower Hamlets 023","E02000886","Total",3185,1033,356,677,49,984,740,244,1087,1039,6,31,11,32
"2011","Tower Hamlets 024","E02000887","Total",3165,614,213,401,75,1633,889,744,806,759,2,27,18,37
"2011","Tower Hamlets 025","E02000888","Total",3306,906,280,626,140,1062,511,551,1144,1092,3,37,12,54
"2011","Tower Hamlets 026","E02000889","Total",2879,952,364,588,64,853,420,433,969,916,4,39,10,41
"2011","Tower Hamlets 027","E02000890","Total",3093,1430,615,815,40,359,246,113,1223,1146,25,39,13,41
"2011","Tower Hamlets 028","E02000891","Total",5742,1345,452,893,209,1397,471,926,2717,2628,8,53,28,74
"2011","Tower Hamlets 030","E02000893","Total",2912,900,307,593,25,1081,235,846,863,823,1,28,11,43
"2011","Tower Hamlets 031","E02000894","Total",4510,1486,446,1040,58,757,140,617,2143,2083,3,44,13,66
"2011","Tower Hamlets 032","E02006853","Total",3320,715,231,484,94,1050,198,852,1401,1346,12,29,14,60
"2011","Tower Hamlets 033","E02006854","Total",2991,779,307,472,94,418,59,359,1658,1601,28,16,13,42
"2011","Wandsworth 001","E02000923","Total",3632,1830,941,889,53,436,336,100,1240,1167,4,56,13,73
"2011","Wandsworth 002","E02000924","Total",5295,1349,509,840,291,1946,1472,474,1653,1570,4,64,15,56
"2011","Wandsworth 003","E02000925","Total",3412,1004,425,579,35,1593,1432,161,745,703,1,34,7,35
"2011","Wandsworth 004","E02000926","Total",4283,1763,711,1052,127,783,391,392,1561,1477,7,65,12,49
"2011","Wandsworth 005","E02000927","Total",3228,1072,368,704,17,1277,351,926,831,784,9,30,8,31
"2011","Wandsworth 006","E02000928","Total",3635,2141,1031,1110,6,375,243,132,1072,1005,14,48,5,41
"2011","Wandsworth 007","E02000929","Total",3201,695,256,439,100,1831,1596,235,551,529,2,16,4,24
"2011","Wandsworth 008","E02000930","Total",4382,1836,664,1172,21,737,465,272,1737,1664,10,59,4,51
"2011","Wandsworth 009","E02000931","Total",3532,2032,779,1253,13,272,48,224,1198,1151,1,45,1,17
"2011","Wandsworth 010","E02000932","Total",4777,2259,888,1371,120,289,130,159,2059,1953,17,75,14,50
"2011","Wandsworth 011","E02000933","Total",3872,2127,1134,993,29,428,320,108,1245,1149,28,52,16,43
"2011","Wandsworth 012","E02000934","Total",4325,1785,606,1179,99,962,152,810,1439,1362,5,62,10,40
"2011","Wandsworth 013","E02000935","Total",2468,551,292,259,14,1406,1318,88,455,436,2,14,3,42
"2011","Wandsworth 014","E02000936","Total",4057,1791,904,887,48,562,395,167,1602,1478,25,77,22,54
"2011","Wandsworth 015","E02000937","Total",3130,1814,759,1055,9,377,130,247,898,856,1,35,6,32
"2011","Wandsworth 016","E02000938","Total",4032,1710,797,913,108,1292,1173,119,880,809,2,27,42,42
"2011","Wandsworth 017","E02000939","Total",2915,1921,918,1003,2,327,142,185,625,587,5,29,4,40
"2011","Wandsworth 018","E02000940","Total",3494,1284,396,888,145,1027,748,279,1012,959,4,36,13,26
"2011","Wandsworth 019","E02000941","Total",4125,2326,797,1529,15,583,156,427,1169,1104,6,52,7,32
"2011","Wandsworth 020","E02000942","Total",3794,2318,1000,1318,34,242,156,86,1156,1061,40,39,16,44
"2011","Wandsworth 021","E02000943","Total",3708,1823,715,1108,44,439,208,231,1367,1313,6,44,4,35
"2011","Wandsworth 022","E02000944","Total",2856,943,359,584,58,991,865,126,839,786,16,26,11,25
"2011","Wandsworth 023","E02000945","Total",2764,872,348,524,28,1114,954,160,731,702,8,14,7,19
"2011","Wandsworth 024","E02000946","Total",3172,1512,482,1030,80,622,442,180,938,887,7,43,1,20
"2011","Wandsworth 025","E02000947","Total",3820,2241,788,1453,49,351,146,205,1152,1092,4,49,7,27
"2011","Wandsworth 026","E02000948","Total",4493,2101,700,1401,52,548,179,369,1753,1685,1,59,8,39
"2011","Wandsworth 027","E02000949","Total",4072,2351,1007,1344,45,291,66,225,1337,1269,17,48,3,48
"2011","Wandsworth 028","E02000950","Total",3233,1622,706,916,20,518,489,29,1033,987,2,39,5,40
"2011","Wandsworth 029","E02000951","Total",2946,1330,559,771,21,447,133,314,1120,1076,3,37,4,28
"2011","Wandsworth 030","E02000952","Total",2644,1152,444,708,5,542,109,433,924,893,2,25,4,21
"2011","Wandsworth 031","E02000953","Total",3113,1485,438,1047,11,741,222,519,848,795,12,32,9,28
"2011","Wandsworth 032","E02000954","Total",2299,1258,582,676,15,269,163,106,739,712,3,17,7,18
"2011","Wandsworth 033","E02000955","Total",2527,1089,487,602,14,642,546,96,755,709,4,38,4,27
"2011","Wandsworth 034","E02000956","Total",3066,975,369,606,41,693,457,236,1317,1264,4,43,6,40
"2011","Wandsworth 035","E02000957","Total",4238,1820,705,1115,81,564,136,428,1715,1641,4,56,14,58
"2011","Wandsworth 036","E02000958","Total",2973,1827,738,1089,13,450,294,156,649,618,3,25,3,34
"2011","Wandsworth 037","E02000959","Total",2980,1384,465,919,48,549,189,360,972,938,1,26,7,27
"2011","Westminster 001","E02000960","Total",3055,1327,908,419,16,322,247,75,1252,1137,58,30,27,138
"2011","Westminster 002","E02000961","Total",4064,1551,874,677,14,836,468,368,1569,1530,5,28,6,94
"2011","Westminster 003","E02000962","Total",4424,1437,912,525,26,1093,416,677,1719,1645,19,41,14,149
"2011","Westminster 004","E02000963","Total",4141,973,398,575,57,2356,1603,753,706,661,4,31,10,49
"2011","Westminster 005","E02000964","Total",5638,1207,445,762,60,2653,581,2072,1646,1570,4,52,20,72
"2011","Westminster 006","E02000965","Total",3981,1425,576,849,20,718,207,511,1753,1693,2,43,15,65
"2011","Westminster 007","E02000966","Total",4714,2027,1098,929,17,584,160,424,1971,1894,8,55,14,115
"2011","Westminster 008","E02000967","Total",3653,1467,927,540,34,186,87,99,1825,1740,16,48,21,141
"2011","Westminster 009","E02000968","Total",5713,993,528,465,49,3145,2218,927,1421,1366,5,30,20,105
"2011","Westminster 010","E02000969","Total",3719,650,296,354,81,2041,1294,747,856,819,3,21,13,91
"2011","Westminster 011","E02000970","Total",4874,1503,1005,498,19,506,62,444,2600,2470,34,36,60,246
"2011","Westminster 012","E02000971","Total",4354,1305,787,518,15,371,105,266,2512,2417,18,38,39,151
"2011","Westminster 013","E02000972","Total",4503,983,543,440,26,1240,481,759,2078,1980,28,37,33,176
"2011","Westminster 014","E02000973","Total",5312,1852,991,861,35,1335,545,790,1985,1905,5,63,12,105
"2011","Westminster 015","E02000974","Total",4380,1460,924,536,30,456,97,359,2242,2160,12,36,34,192
"2011","Westminster 016","E02000975","Total",4621,1457,810,647,37,362,146,216,2655,2563,5,61,26,110
"2011","Westminster 017","E02000976","Total",5041,1546,893,653,23,599,473,126,2717,2615,8,65,29,156
"2011","Westminster 018","E02000977","Total",3895,987,656,331,17,866,215,651,1810,1667,42,31,70,215
"2011","Westminster 019","E02000978","Total",3882,1793,1333,460,20,150,25,125,1531,1398,37,41,55,388
"2011","Westminster 020","E02000979","Total",3892,1227,822,405,39,1096,72,1024,1335,1118,107,40,70,195
"2011","Westminster 021","E02000980","Total",4498,1332,745,587,66,1848,1238,610,1144,1051,13,65,15,108
"2011","Westminster 022","E02000981","Total",4853,1730,970,760,55,1175,84,1091,1791,1679,8,87,17,102
"2011","Westminster 023","E02000982","Total",4143,1003,604,399,109,1888,920,968,1077,982,27,43,25,66
"2011","Westminster 024","E02000983","Total",4422,1052,647,405,20,1522,799,723,1754,1672,6,49,27,74
"2011","Barking and Dagenham 001","E02000002","Total",2713,1259,596,663,18,1133,894,239,269,255,0,14,0,34
"2011","Barking and Dagenham 002","E02000003","Total",3834,2501,1028,1473,34,446,359,87,830,788,1,35,6,23
"2011","Barking and Dagenham 003","E02000004","Total",2318,1687,718,969,16,371,268,103,228,213,0,12,3,16
"2011","Barking and Dagenham 004","E02000005","Total",3183,1857,711,1146,18,793,702,91,482,456,0,20,6,33
"2011","Barking and Dagenham 006","E02000007","Total",3441,1379,558,821,32,1663,1570,93,333,305,3,18,7,34
"2011","Barking and Dagenham 007","E02000008","Total",4591,2099,708,1391,49,1762,1579,183,641,589,1,39,12,40
"2011","Barking and Dagenham 008","E02000009","Total",3212,1475,488,987,79,982,797,185,619,589,1,22,7,57
"2011","Barking and Dagenham 009","E02000010","Total",3292,1491,463,1028,62,1195,1039,156,517,478,1,32,6,27
"2011","Barking and Dagenham 010","E02000011","Total",2289,1521,672,849,12,289,203,86,440,416,3,18,3,27
"2011","Barking and Dagenham 011","E02000012","Total",3258,2254,935,1319,12,475,374,101,476,455,1,15,5,41
"2011","Barking and Dagenham 012","E02000013","Total",3125,1439,479,960,37,1181,1093,88,435,402,2,28,3,33
"2011","Barking and Dagenham 013","E02000014","Total",3531,1548,557,991,16,1413,1211,202,527,501,4,13,9,27
"2011","Barking and Dagenham 014","E02000015","Total",3170,980,369,611,60,1604,1261,343,505,483,2,14,6,21
"2011","Barking and Dagenham 015","E02000016","Total",2934,663,160,503,40,1038,690,348,1172,1105,5,29,33,21
"2011","Barking and Dagenham 016","E02000017","Total",2729,1552,641,911,21,267,206,61,860,795,0,56,9,29
"2011","Barking and Dagenham 017","E02000018","Total",3326,1291,403,888,44,1405,1163,242,565,530,0,25,10,21
"2011","Barking and Dagenham 018","E02000019","Total",3010,1393,404,989,68,1045,844,201,472,453,1,16,2,32
"2011","Barking and Dagenham 019","E02000020","Total",3460,1482,521,961,53,1260,1050,210,633,577,4,45,7,32
"2011","Barking and Dagenham 020","E02000021","Total",2949,1592,582,1010,44,565,372,193,717,687,3,18,9,31
"2011","Barking and Dagenham 021","E02000022","Total",3261,482,129,353,121,2061,1929,132,563,520,1,26,16,34
"2011","Barking and Dagenham 022","E02000023","Total",2431,717,203,514,31,1271,1182,89,396,371,0,23,2,16
"2011","Barking and Dagenham 023","E02006799","Total",3624,1662,583,1079,39,1240,996,244,648,591,6,37,14,35
"2011","Barnet 001","E02000024","Total",4110,3041,1507,1534,43,214,87,127,753,712,5,29,7,59
"2011","Barnet 002","E02000025","Total",3622,2272,1050,1222,33,512,276,236,763,736,3,18,6,42
"2011","Barnet 003","E02000026","Total",2496,1898,951,947,24,133,79,54,404,374,0,17,13,37
"2011","Barnet 004","E02000027","Total",3705,1951,879,1072,82,1259,920,339,369,340,5,18,6,44
"2011","Barnet 005","E02000028","Total",2473,1773,878,895,14,89,38,51,574,546,1,24,3,23
"2011","Barnet 006","E02000029","Total",3513,2233,961,1272,14,336,188,148,890,848,4,34,4,40
"2011","Barnet 007","E02000030","Total",3410,2649,1450,1199,10,385,328,57,303,287,3,9,4,63
"2011","Barnet 008","E02000031","Total",2817,1899,1078,821,21,231,94,137,633,572,26,13,22,33
"2011","Barnet 009","E02000032","Total",2742,2353,1163,1190,4,81,17,64,280,263,3,11,3,24
"2011","Barnet 010","E02000033","Total",3317,2216,1023,1193,85,466,200,266,520,487,3,26,4,30
"2011","Barnet 011","E02000034","Total",3403,2189,1019,1170,14,334,192,142,811,774,4,23,10,55
"2011","Barnet 012","E02000035","Total",3381,1880,949,931,29,437,199,238,991,944,12,22,13,44
"2011","Barnet 013","E02000036","Total",3942,2571,1097,1474,52,498,251,247,770,722,4,39,5,51
"2011","Barnet 014","E02000037","Total",3397,2220,1088,1132,32,686,442,244,411,396,0,12,3,48
"2011","Barnet 015","E02000038","Total",4049,2570,1066,1504,14,391,221,170,989,937,4,46,2,85
"2011","Barnet 016","E02000039","Total",2485,1811,849,962,4,101,77,24,542,515,4,17,6,27
"2011","Barnet 017","E02000040","Total",2649,1494,766,728,15,660,272,388,388,336,23,19,10,92
"2011","Barnet 018","E02000041","Total",3120,1886,909,977,8,343,238,105,831,798,6,21,6,52
"2011","Barnet 019","E02000042","Total",4421,2346,1103,1243,17,384,259,125,1575,1516,11,37,11,99
"2011","Barnet 020","E02000043","Total",2693,1912,984,928,11,65,43,22,679,668,1,7,3,26
"2011","Barnet 021","E02000044","Total",2862,1347,512,835,60,882,647,235,542,517,2,18,5,31
"2011","Barnet 022","E02000045","Total",4168,2093,793,1300,45,893,627,266,1037,980,4,45,8,100
"2011","Barnet 023","E02000046","Total",2860,1438,721,717,7,131,25,106,1249,1200,5,25,19,35
"2011","Barnet 024","E02000047","Total",4036,1645,596,1049,58,1257,1007,250,1018,967,15,24,12,58
"2011","Barnet 025","E02000048","Total",3784,2595,1209,1386,11,200,67,133,933,881,5,46,1,45
"2011","Barnet 026","E02000049","Total",3028,587,202,385,103,1886,1181,705,404,370,1,15,18,48
"2011","Barnet 027","E02000050","Total",3853,1950,874,1076,61,955,294,661,842,804,2,29,7,45
"2011","Barnet 028","E02000051","Total",3537,2077,1197,880,8,218,173,45,1132,1080,6,31,15,102
"2011","Barnet 029","E02000052","Total",4163,2151,988,1163,16,682,469,213,1258,1216,2,32,8,56
"2011","Barnet 030","E02000053","Total",3244,1399,615,784,94,502,195,307,1206,1151,8,33,14,43
"2011","Barnet 031","E02000054","Total",2774,1498,678,820,33,189,35,154,1027,983,8,30,6,27
"2011","Barnet 032","E02000055","Total",4179,1914,1033,881,19,601,415,186,1553,1476,6,48,23,92
"2011","Barnet 033","E02000056","Total",3390,2370,1380,990,5,183,45,138,743,696,8,27,12,89
"2011","Barnet 034","E02000057","Total",2460,1351,717,634,7,149,88,61,902,867,3,30,2,51
"2011","Barnet 035","E02000058","Total",3961,2462,1418,1044,15,222,83,139,1207,1162,6,31,8,55
"2011","Barnet 036","E02000059","Total",3990,1813,884,929,29,942,759,183,1151,1109,5,26,11,55
"2011","Barnet 037","E02000060","Total",3400,1675,932,743,17,250,23,227,1390,1334,6,31,19,68
"2011","Barnet 038","E02000061","Total",3172,1609,992,617,16,97,45,52,1372,1312,10,39,11,78
"2011","Barnet 039","E02000062","Total",2357,855,360,495,28,710,457,253,729,700,4,19,6,35
"2011","Barnet 040","E02000063","Total",2503,1339,690,649,15,158,87,71,940,905,3,24,8,51
"2011","Barnet 041","E02000064","Total",2450,1018,544,474,18,622,521,101,743,694,9,28,12,49
"2011","Bexley 001","E02000065","Total",2728,1394,296,1098,19,622,81,541,666,632,0,27,7,27
"2011","Bexley 002","E02000066","Total",3795,1360,506,854,9,1907,166,1741,482,437,1,40,4,37
"2011","Bexley 003","E02000067","Total",3580,2069,727,1342,19,699,94,605,754,699,1,38,16,39
"2011","Bexley 004","E02000068","Total",3041,1433,474,959,141,728,81,647,700,663,2,23,12,39
"2011","Bexley 005","E02000069","Total",2495,1766,824,942,16,315,34,281,380,356,2,21,1,18
"2011","Bexley 006","E02000070","Total",3177,2591,1331,1260,40,244,37,207,281,255,2,22,2,21
"2011","Bexley 007","E02000071","Total",2782,2138,912,1226,18,316,46,270,278,254,0,21,3,32
"2011","Bexley 008","E02000072","Total",4722,1928,575,1353,22,2087,375,1712,636,597,0,26,13,49
"2011","Bexley 009","E02000073","Total",3968,3542,1683,1859,19,163,24,139,224,198,0,23,3,20
"2011","Bexley 010","E02000074","Total",3185,1652,630,1022,91,1149,125,1024,267,241,1,20,5,26
"2011","Bexley 011","E02000075","Total",3172,2796,1468,1328,8,176,25,151,171,159,0,11,1,21
"2011","Bexley 013","E02000077","Total",2870,2320,979,1341,15,276,37,239,235,212,0,22,1,24
"2011","Bexley 014","E02000078","Total",3036,2632,1155,1477,18,128,28,100,241,212,0,27,2,17
"2011","Bexley 015","E02000079","Total",3267,2558,1240,1318,14,132,17,115,526,480,2,42,2,37
"2011","Bexley 016","E02000080","Total",3702,2999,1423,1576,32,231,25,206,410,380,3,23,4,30
"2011","Bexley 017","E02000081","Total",3106,2375,1162,1213,6,438,49,389,258,230,4,20,4,29
"2011","Bexley 018","E02000082","Total",3356,3014,1328,1686,23,17,2,15,273,243,1,29,0,29
"2011","Bexley 019","E02000083","Total",3985,2808,1081,1727,17,715,147,568,416,379,1,31,5,29
"2011","Bexley 020","E02000084","Total",4209,3625,1696,1929,28,175,11,164,353,319,3,30,1,28
"2011","Bexley 021","E02000085","Total",3084,2621,1113,1508,16,135,17,118,295,274,1,17,3,17
"2011","Bexley 022","E02000086","Total",2789,2506,1104,1402,13,23,3,20,232,213,1,16,2,15
"2011","Bexley 023","E02000087","Total",3142,2666,1436,1230,4,127,11,116,318,295,2,17,4,27
"2011","Bexley 024","E02000088","Total",2984,2650,1249,1401,7,99,12,87,208,185,1,19,3,20
"2011","Bexley 025","E02000089","Total",2899,2553,1200,1353,11,148,7,141,168,153,0,14,1,19
"2011","Bexley 026","E02000090","Total",3962,2809,1397,1412,56,356,32,324,707,654,8,42,3,34
"2011","Bexley 027","E02000091","Total",4279,2964,1595,1369,16,694,29,665,575,538,4,31,2,30
"2011","Bexley 028","E02000092","Total",2722,1499,656,843,57,889,119,770,245,229,2,14,0,32
"2011","Bexley 029","E02006785","Total",2567,1886,887,999,19,388,59,329,257,234,0,22,1,17
"2011","Brent 001","E02000093","Total",3408,2176,1108,1068,59,402,64,338,718,689,1,21,7,53
"2011","Brent 002","E02000094","Total",2738,1599,750,849,46,396,88,308,655,632,0,14,9,42
"2011","Brent 003","E02000095","Total",3117,1868,1025,843,29,398,215,183,780,739,7,24,10,42
"2011","Brent 004","E02000096","Total",2518,1898,1027,871,5,109,45,64,469,443,8,13,5,37
"2011","Brent 005","E02000097","Total",2926,1845,877,968,12,317,200,117,714,681,2,24,7,38
"2011","Brent 006","E02000098","Total",2652,1425,696,729,34,482,213,269,674,640,3,21,10,37
"2011","Brent 007","E02000099","Total",2782,1442,701,741,53,377,91,286,865,826,7,22,10,45
"2011","Brent 008","E02000100","Total",2696,1768,899,869,26,441,36,405,434,399,4,10,21,27
"2011","Brent 009","E02000101","Total",3312,1240,569,671,85,1047,329,718,882,854,0,16,12,58
"2011","Brent 010","E02000102","Total",2496,1142,604,538,49,590,129,461,698,670,8,13,7,17
"2011","Brent 011","E02000103","Total",2994,1418,706,712,54,772,379,393,710,678,3,21,8,40
"2011","Brent 012","E02000104","Total",2213,1286,684,602,47,254,104,150,596,568,1,20,7,30
"2011","Brent 013","E02000105","Total",2997,1479,613,866,26,424,178,246,1017,974,2,31,10,51
"2011","Brent 014","E02000106","Total",3449,1450,700,750,40,642,233,409,1270,1222,7,33,8,47
"2011","Brent 015","E02000107","Total",4107,1475,699,776,21,630,174,456,1941,1883,4,42,12,40
"2011","Brent 016","E02000108","Total",2147,1176,534,642,20,337,152,185,585,559,3,19,4,29
"2011","Brent 017","E02000109","Total",3264,1536,791,745,129,487,161,326,1072,1025,5,31,11,40
"2011","Brent 018","E02000110","Total",2969,1357,686,671,24,593,188,405,972,928,4,27,13,23
"2011","Brent 019","E02000111","Total",2914,1479,711,768,31,389,164,225,971,910,5,38,18,44
"2011","Brent 020","E02000112","Total",2892,1503,776,727,48,264,90,174,1036,987,12,27,10,41
"2011","Brent 021","E02000113","Total",3306,736,292,444,60,1956,1339,617,494,473,0,13,8,60
"2011","Brent 022","E02000114","Total",3528,1081,466,615,77,727,191,536,1586,1544,5,23,14,57
"2011","Brent 023","E02000115","Total",3911,1249,545,704,29,1031,605,426,1549,1499,2,34,14,53
"2011","Brent 024","E02000116","Total",3072,679,311,368,105,1012,200,812,1226,1188,2,20,16,50
"2011","Brent 025","E02000117","Total",4557,1020,429,591,84,2153,400,1753,1214,1175,0,24,15,86
"2011","Brent 026","E02000118","Total",2849,1484,632,852,39,582,299,283,710,659,2,37,12,34
"2011","Brent 027","E02000119","Total",2597,335,135,200,97,1722,681,1041,397,379,0,9,9,46
"2011","Brent 028","E02000120","Total",4277,1436,558,878,26,1008,319,689,1766,1700,6,48,12,41
"2011","Brent 029","E02000121","Total",2623,1393,700,693,45,246,63,183,884,823,4,31,26,55
"2011","Brent 030","E02000122","Total",3047,1659,820,839,8,545,223,322,775,739,6,23,7,60
"2011","Brent 031","E02000123","Total",5884,1415,526,889,90,1997,484,1513,2303,2224,2,42,35,79
"2011","Brent 032","E02000124","Total",4334,1776,766,1010,31,898,464,434,1567,1508,7,32,20,62
"2011","Brent 033","E02000125","Total",4329,2094,933,1161,45,926,266,660,1213,1162,1,39,11,51
"2011","Brent 034","E02000126","Total",3381,405,147,258,62,2437,1919,518,438,404,3,13,18,39
"2011","Bromley 001","E02000127","Total",3675,1894,767,1127,40,1314,174,1140,381,360,3,15,3,46
"2011","Bromley 002","E02000128","Total",3006,2222,927,1295,10,376,36,340,372,348,6,13,5,26
"2011","Bromley 004","E02000130","Total",3464,2040,765,1275,43,660,41,619,691,651,4,23,13,30
"2011","Bromley 005","E02000131","Total",4589,1775,478,1297,39,1210,111,1099,1534,1484,2,42,6,31
"2011","Bromley 006","E02000132","Total",4668,2481,1150,1331,53,703,44,659,1369,1316,3,42,8,62
"2011","Bromley 007","E02000133","Total",3961,3360,1789,1571,21,98,1,97,436,413,2,18,3,46
"2011","Bromley 008","E02000134","Total",5106,2932,1151,1781,22,871,74,797,1220,1150,7,51,12,61
"2011","Bromley 009","E02000135","Total",4402,1115,336,779,91,2225,272,1953,940,896,7,26,11,31
"2011","Bromley 010","E02000136","Total",2207,1600,819,781,10,427,53,374,130,115,3,8,4,40
"2011","Bromley 011","E02000137","Total",3637,2645,1272,1373,16,269,26,243,684,644,6,32,2,23
"2011","Bromley 012","E02000138","Total",4057,2931,1587,1344,9,143,4,139,911,847,5,48,11,63
"2011","Bromley 013","E02000139","Total",3202,2147,762,1385,51,429,43,386,543,519,1,19,4,32
"2011","Bromley 014","E02000140","Total",3301,1517,645,872,63,1485,199,1286,211,188,3,17,3,25
"2011","Bromley 015","E02000141","Total",3055,1973,686,1287,34,451,39,412,575,539,3,31,2,22
"2011","Bromley 016","E02000142","Total",3283,2506,1118,1388,24,195,12,183,527,487,3,32,5,31
"2011","Bromley 018","E02000144","Total",3831,2608,1189,1419,14,201,11,190,969,929,3,33,4,39
"2011","Bromley 019","E02000145","Total",3376,1700,651,1049,78,1228,213,1015,338,288,10,33,7,32
"2011","Bromley 020","E02000146","Total",3508,2571,1010,1561,43,287,18,269,574,543,2,27,2,33
"2011","Bromley 021","E02000147","Total",3183,2725,1485,1240,6,118,7,111,312,292,0,15,5,22
"2011","Bromley 022","E02000148","Total",2633,2225,1165,1060,4,173,6,167,205,188,3,11,3,26
"2011","Bromley 023","E02000149","Total",3249,2178,941,1237,38,681,78,603,323,298,0,25,0,29
"2011","Bromley 024","E02000150","Total",3109,2536,1098,1438,8,287,26,261,254,234,7,9,4,24
"2011","Bromley 025","E02000151","Total",2994,2738,1462,1276,4,49,2,47,175,164,0,11,0,28
"2011","Bromley 026","E02000152","Total",2623,1605,675,930,25,821,131,690,142,134,2,6,0,30
"2011","Bromley 027","E02000153","Total",2860,2648,1243,1405,4,98,9,89,98,87,2,9,0,12
"2011","Bromley 028","E02000154","Total",3293,2503,1261,1242,32,297,35,262,440,402,5,29,4,21
"2011","Bromley 029","E02000155","Total",3057,2512,1362,1150,38,262,35,227,222,203,0,18,1,23
"2011","Bromley 030","E02000156","Total",4756,4058,2127,1931,21,242,10,232,380,342,8,20,10,55
"2011","Bromley 031","E02000157","Total",3300,2990,1705,1285,7,64,6,58,209,190,0,17,2,30
"2011","Bromley 032","E02000158","Total",2952,2115,1198,917,23,662,89,573,137,123,0,12,2,15
"2011","Bromley 033","E02000159","Total",2749,2422,1331,1091,15,66,8,58,222,212,0,5,5,24
"2011","Bromley 034","E02000160","Total",2968,2576,1255,1321,4,80,8,72,279,251,9,17,2,29
"2011","Bromley 035","E02000161","Total",3369,3052,1513,1539,8,76,10,66,212,192,4,14,2,21
"2011","Bromley 036","E02000162","Total",2889,2140,1192,948,8,513,17,496,204,177,6,15,6,24
"2011","Bromley 037","E02000163","Total",3072,2597,1334,1263,26,203,26,177,223,194,3,19,7,23
"2011","Bromley 039","E02000165","Total",2691,2364,918,1446,27,130,12,118,151,139,2,9,1,19
"2011","Bromley 040","E02006782","Total",3091,2157,1027,1130,28,633,69,564,247,215,2,25,5,26
"2011","Bromley 041","E02006787","Total",3034,2377,991,1386,25,281,24,257,321,301,1,19,0,30
"2011","Bromley 042","E02006789","Total",2662,2250,1264,986,24,117,8,109,232,174,36,11,11,39
"2011","Croydon 001","E02000194","Total",4099,1940,731,1209,52,1002,553,449,1065,1001,8,40,16,40
"2011","Croydon 002","E02000195","Total",3446,2468,1102,1366,51,264,146,118,619,572,5,33,9,44
"2011","Croydon 003","E02000196","Total",2553,1496,655,841,44,446,297,149,540,508,3,26,3,27
"2011","Croydon 004","E02000197","Total",3403,1823,767,1056,48,631,442,189,859,819,1,32,7,42
"2011","Croydon 005","E02000198","Total",3338,1651,542,1109,33,718,320,398,892,827,4,46,15,44
"2011","Croydon 006","E02000199","Total",3172,2056,671,1385,18,351,90,261,700,646,4,42,8,47
"2011","Croydon 007","E02000200","Total",3811,2036,666,1370,28,473,141,332,1228,1176,4,34,14,46
"2011","Croydon 008","E02000201","Total",3814,1437,426,1011,26,1124,519,605,1175,1132,2,27,14,52
"2011","Croydon 009","E02000202","Total",2981,2014,835,1179,21,163,63,100,747,704,0,38,5,36
"2011","Croydon 010","E02000203","Total",3062,1400,498,902,71,687,378,309,880,820,11,41,8,24
"2011","Croydon 011","E02000204","Total",3146,1974,844,1130,39,266,68,198,815,770,2,38,5,52
"2011","Croydon 013","E02000206","Total",4009,1695,505,1190,61,1049,505,544,1136,1082,3,37,14,68
"2011","Croydon 014","E02000207","Total",3592,1721,547,1174,95,1007,361,646,731,699,0,25,7,38
"2011","Croydon 015","E02000208","Total",3821,1322,372,950,174,1113,456,657,1135,1090,3,20,22,77
"2011","Croydon 016","E02000209","Total",2919,1655,539,1116,22,504,131,373,711,660,1,34,16,27
"2011","Croydon 017","E02000210","Total",3371,2212,723,1489,61,377,144,233,690,645,3,32,10,31
"2011","Croydon 018","E02000211","Total",3279,2780,1264,1516,6,200,18,182,276,252,4,18,2,17
"2011","Croydon 019","E02000212","Total",2977,1358,467,891,64,740,458,282,788,745,0,32,11,27
"2011","Croydon 020","E02000213","Total",4160,1166,385,781,72,1201,734,467,1656,1594,7,49,6,65
"2011","Croydon 021","E02000214","Total",2321,1854,874,980,40,129,28,101,280,259,0,19,2,18
"2011","Croydon 022","E02000215","Total",4991,2125,791,1334,54,800,413,387,1948,1862,7,62,17,64
"2011","Croydon 023","E02000216","Total",3028,1673,968,705,4,350,23,327,964,929,0,31,4,37
"2011","Croydon 024","E02000217","Total",4273,1936,593,1343,103,953,445,508,1235,1167,10,39,19,46
"2011","Croydon 025","E02000218","Total",2369,1378,649,729,5,826,691,135,139,122,4,11,2,21
"2011","Croydon 026","E02000219","Total",2999,2662,1422,1240,7,84,30,54,204,182,5,11,6,42
"2011","Croydon 027","E02000220","Total",4847,1676,615,1061,180,756,262,494,2172,2073,26,49,24,63
"2011","Croydon 028","E02000221","Total",3866,1874,701,1173,59,1264,857,407,612,570,11,28,3,57
"2011","Croydon 029","E02000222","Total",3539,2142,863,1279,56,343,61,282,968,920,4,40,4,30
"2011","Croydon 030","E02000223","Total",2875,796,314,482,6,1914,1679,235,135,128,0,4,3,24
"2011","Croydon 031","E02000224","Total",3309,2047,718,1329,42,246,66,180,934,891,4,33,6,40
"2011","Croydon 032","E02000225","Total",2708,1504,630,874,23,1012,705,307,152,139,0,11,2,17
"2011","Croydon 033","E02000226","Total",2796,2535,1287,1248,7,31,19,12,201,185,7,7,2,22
"2011","Croydon 034","E02000227","Total",4851,3622,1533,2089,31,510,335,175,656,590,5,58,3,32
"2011","Croydon 035","E02000228","Total",2924,2587,1410,1177,2,76,52,24,233,216,3,13,1,26
"2011","Croydon 036","E02000229","Total",2413,975,384,591,22,1181,916,265,211,195,4,9,3,24
"2011","Croydon 037","E02000230","Total",4004,2838,1275,1563,69,277,70,207,780,742,2,32,4,40
"2011","Croydon 038","E02000231","Total",2543,2233,1072,1161,2,40,17,23,251,228,2,14,7,17
"2011","Croydon 039","E02000232","Total",2324,1931,953,978,6,243,208,35,128,121,4,3,0,16
"2011","Croydon 040","E02000233","Total",2391,1758,654,1104,10,333,210,123,272,255,0,16,1,18
"2011","Croydon 041","E02000234","Total",3161,2175,928,1247,79,408,153,255,468,442,2,21,3,31
"2011","Croydon 042","E02000235","Total",2694,2154,946,1208,38,282,133,149,203,187,2,12,2,17
"2011","Croydon 043","E02000236","Total",2838,2490,1069,1421,6,142,100,42,188,172,2,14,0,12
"2011","Croydon 044","E02000237","Total",3090,2491,1231,1260,0,406,382,24,162,134,8,17,3,31
"2011","Croydon 045","E02006788","Total",2903,1570,463,1107,18,965,683,282,333,311,4,14,4,17
"2011","Ealing 001","E02000238","Total",3179,1994,753,1241,43,382,244,138,730,700,1,25,4,30
"2011","Ealing 002","E02000239","Total",2924,2058,1008,1050,31,93,77,16,721,683,7,24,7,21
"2011","Ealing 003","E02000240","Total",3770,1817,711,1106,89,1218,851,367,597,565,1,22,9,49
"2011","Ealing 004","E02000241","Total",2366,1576,668,908,16,155,56,99,585,554,6,24,1,34
"2011","Ealing 005","E02000242","Total",2151,1371,607,764,14,102,70,32,641,600,1,31,9,23
"2011","Ealing 006","E02000243","Total",3068,1674,718,956,31,534,329,205,783,748,3,30,2,46
"2011","Ealing 007","E02000244","Total",2658,1678,759,919,33,188,95,93,713,670,6,34,3,46
"2011","Ealing 008","E02000245","Total",3210,1124,360,764,82,1308,844,464,650,629,1,12,8,46
"2011","Ealing 009","E02000246","Total",3071,1465,563,902,22,1015,887,128,518,493,1,18,6,51
"2011","Ealing 010","E02000247","Total",3755,1794,653,1141,124,912,554,358,883,840,1,34,8,42
"2011","Ealing 011","E02000248","Total",2902,1387,744,643,86,104,38,66,1276,1231,3,36,6,49
"2011","Ealing 012","E02000249","Total",2739,1470,716,754,82,438,328,110,702,671,3,23,5,47
"2011","Ealing 013","E02000250","Total",2541,1844,930,914,32,104,77,27,541,528,1,9,3,20
"2011","Ealing 014","E02000251","Total",2442,1713,758,955,23,123,49,74,551,522,0,25,4,32
"2011","Ealing 015","E02000252","Total",3717,1217,582,635,219,888,205,683,1331,1288,4,22,17,62
"2011","Ealing 016","E02000253","Total",3744,1583,630,953,31,1541,1348,193,522,497,0,18,7,67
"2011","Ealing 017","E02000254","Total",2487,1713,815,898,10,207,154,53,517,479,1,33,4,40
"2011","Ealing 018","E02000255","Total",3622,2013,941,1072,21,733,455,278,810,787,3,17,3,45
"2011","Ealing 019","E02000256","Total",3782,1777,907,870,87,349,65,284,1519,1476,7,25,11,50
"2011","Ealing 020","E02000257","Total",5873,2453,1305,1148,29,646,125,521,2658,2586,14,52,6,87
"2011","Ealing 021","E02000258","Total",2544,1147,523,624,28,412,114,298,927,872,3,21,31,30
"2011","Ealing 022","E02000259","Total",2283,1462,634,828,15,202,77,125,584,558,7,14,5,20
"2011","Ealing 023","E02000260","Total",2468,1404,743,661,25,395,229,166,593,547,2,30,14,51
"2011","Ealing 024","E02000261","Total",4110,1559,744,815,249,971,533,438,1265,1213,4,28,20,66
"2011","Ealing 025","E02000262","Total",3771,1400,517,883,53,944,365,579,1326,1282,1,33,10,48
"2011","Ealing 026","E02000263","Total",3155,1794,945,849,55,477,144,333,756,693,4,29,30,73
"2011","Ealing 027","E02000264","Total",3205,1550,781,769,37,324,82,242,1251,1214,5,22,10,43
"2011","Ealing 028","E02000265","Total",4747,1944,694,1250,115,1255,618,637,1356,1305,6,33,12,77
"2011","Ealing 029","E02000266","Total",3711,1232,573,659,153,1728,1072,656,534,494,4,26,10,64
"2011","Ealing 030","E02000267","Total",2847,1593,588,1005,69,328,128,200,823,785,3,20,15,34
"2011","Ealing 031","E02000268","Total",3824,1981,888,1093,35,643,483,160,1108,1071,6,24,7,57
"2011","Ealing 032","E02000269","Total",3245,2061,926,1135,13,168,91,77,956,918,5,27,6,47
"2011","Ealing 033","E02000270","Total",3331,819,316,503,84,1633,1256,377,703,674,2,20,7,92
"2011","Ealing 034","E02000271","Total",2871,1820,871,949,24,168,84,84,825,802,2,16,5,34
"2011","Ealing 035","E02000272","Total",2579,1909,940,969,18,144,105,39,486,468,1,16,1,22
"2011","Ealing 037","E02000274","Total",3557,1837,852,985,59,486,133,353,1101,1027,8,39,27,74
"2011","Ealing 038","E02000275","Total",2131,1089,521,568,17,455,226,229,525,489,6,16,14,45
"2011","Ealing 039","E02000276","Total",2634,1532,583,949,9,283,168,115,780,742,5,30,3,30
"2011","Ealing 040","E02006791","Total",3068,1566,647,919,11,416,248,168,1035,995,5,31,4,40
"2011","Enfield 001","E02000277","Total",2651,1777,773,1004,44,302,157,145,496,465,4,26,1,32
"2011","Enfield 002","E02000278","Total",3278,1522,677,845,57,1097,796,301,555,536,1,16,2,47
"2011","Enfield 003","E02000279","Total",4356,2046,603,1443,73,1048,446,602,1128,1087,1,28,12,61
"2011","Enfield 004","E02000280","Total",3466,2266,1002,1264,40,688,574,114,421,388,7,23,3,51
"2011","Enfield 005","E02000281","Total",3531,1969,730,1239,26,713,487,226,771,742,4,20,5,52
"2011","Enfield 006","E02000282","Total",3491,1357,477,880,29,1208,966,242,840,814,4,11,11,57
"2011","Enfield 007","E02000283","Total",2843,1784,711,1073,17,496,359,137,508,481,0,21,6,38
"2011","Enfield 008","E02000284","Total",3497,2352,1025,1327,35,365,272,93,704,658,7,33,6,41
"2011","Enfield 009","E02000285","Total",2466,2126,1075,1051,10,87,41,46,215,200,4,5,6,28
"2011","Enfield 010","E02000286","Total",3863,2707,1387,1320,13,176,86,90,926,853,28,31,14,41
"2011","Enfield 011","E02000287","Total",2540,1886,1054,832,7,247,175,72,361,343,4,5,9,39
"2011","Enfield 012","E02000288","Total",3784,1902,768,1134,89,806,531,275,925,893,5,19,8,62
"2011","Enfield 013","E02000289","Total",2421,2061,1119,942,12,155,93,62,169,155,1,9,4,24
"2011","Enfield 014","E02000290","Total",2853,956,364,592,33,1124,894,230,705,676,3,23,3,35
"2011","Enfield 015","E02000291","Total",3998,2208,1003,1205,14,631,484,147,1107,1068,0,29,10,38
"2011","Enfield 016","E02000292","Total",3578,2585,1073,1512,13,293,240,53,660,636,0,21,3,27
"2011","Enfield 017","E02000293","Total",2470,2069,1143,926,3,66,37,29,300,281,2,14,3,32
"2011","Enfield 018","E02000294","Total",3009,1825,801,1024,15,517,386,131,599,567,1,24,7,53
"2011","Enfield 019","E02000295","Total",3347,2279,1138,1141,53,313,128,185,671,649,2,17,3,31
"2011","Enfield 020","E02000296","Total",3941,2077,1092,985,24,447,373,74,1337,1282,7,42,6,56
"2011","Enfield 021","E02000297","Total",3482,2971,1499,1472,7,74,54,20,398,377,0,17,4,32
"2011","Enfield 022","E02000298","Total",3075,2385,1181,1204,5,121,92,29,530,507,6,15,2,34
"2011","Enfield 023","E02000299","Total",3438,1727,759,968,75,636,344,292,947,901,3,24,19,53
"2011","Enfield 024","E02000300","Total",2998,1635,690,945,14,364,222,142,932,899,0,22,11,53
"2011","Enfield 025","E02000301","Total",3923,1496,605,891,53,1319,700,619,989,957,1,23,8,66
"2011","Enfield 026","E02000302","Total",3123,2145,1029,1116,12,401,277,124,518,497,3,14,4,47
"2011","Enfield 027","E02000303","Total",3120,1202,437,765,14,1066,722,344,779,749,4,13,13,59
"2011","Enfield 028","E02000304","Total",2964,2308,1196,1112,24,81,54,27,523,502,2,17,2,28
"2011","Enfield 029","E02000305","Total",3481,2157,899,1258,11,166,61,105,1096,1043,7,33,13,51
"2011","Enfield 030","E02000306","Total",3594,752,248,504,130,1979,1036,943,667,640,0,17,10,66
"2011","Enfield 031","E02000307","Total",3368,2241,1010,1231,14,291,208,83,766,734,3,26,3,56
"2011","Enfield 032","E02000308","Total",2908,1576,805,771,7,546,417,129,738,696,2,22,18,41
"2011","Enfield 033","E02000309","Total",3785,1695,645,1050,41,847,559,288,1118,1071,6,26,15,84
"2011","Enfield 035","E02000311","Total",3656,2138,995,1143,33,596,244,352,846,806,1,30,9,43
"2011","Enfield 036","E02000312","Total",4262,2257,1068,1189,32,341,145,196,1556,1494,3,37,22,76
"2011","Enfield 037","E02006793","Total",3356,1023,371,652,8,1466,1006,460,790,748,2,32,8,69
"2011","Greenwich 001","E02000313","Total",2575,584,168,416,39,1621,111,1510,314,288,1,17,8,17
"2011","Greenwich 002","E02000314","Total",4382,1689,271,1418,188,1025,84,941,1447,1389,3,48,7,33
"2011","Greenwich 003","E02000315","Total",3440,1291,494,797,20,1604,1385,219,487,463,1,19,4,38
"2011","Greenwich 004","E02000316","Total",4944,913,202,711,334,2013,1362,651,1630,1565,5,48,12,54
"2011","Greenwich 005","E02000317","Total",3200,634,220,414,33,2063,1698,365,424,399,0,18,7,46
"2011","Greenwich 006","E02000318","Total",3283,1430,493,937,21,843,444,399,951,904,1,36,10,38
"2011","Greenwich 007","E02000319","Total",3866,1370,453,917,106,1210,541,669,1142,1084,3,39,16,38
"2011","Greenwich 008","E02000320","Total",2524,1356,497,859,13,717,630,87,419,396,1,20,2,19
"2011","Greenwich 009","E02000321","Total",2877,679,234,445,45,1581,1395,186,522,497,1,13,11,50
"2011","Greenwich 011","E02000323","Total",4001,961,340,621,108,1976,1508,468,912,859,3,36,14,44
"2011","Greenwich 012","E02000324","Total",2807,909,320,589,8,1483,822,661,374,350,0,18,6,33
"2011","Greenwich 014","E02000326","Total",2932,1483,547,936,13,878,281,597,538,498,4,30,6,20
"2011","Greenwich 015","E02000327","Total",2357,433,101,332,35,1206,1021,185,659,403,137,24,95,24
"2011","Greenwich 016","E02000328","Total",3070,1437,610,827,68,889,601,288,656,636,1,15,4,20
"2011","Greenwich 017","E02000329","Total",2364,1443,538,905,19,545,307,238,330,308,0,18,4,27
"2011","Greenwich 019","E02000331","Total",3236,1401,464,937,32,1142,853,289,630,586,0,34,10,31
"2011","Greenwich 020","E02000332","Total",2958,1982,827,1155,21,495,255,240,435,414,3,13,5,25
"2011","Greenwich 021","E02000333","Total",3005,1598,746,852,7,469,313,156,890,850,9,20,11,41
"2011","Greenwich 022","E02000334","Total",2585,1515,586,929,17,725,641,84,297,279,0,14,4,31
"2011","Greenwich 023","E02000335","Total",2637,2043,881,1162,11,376,153,223,193,169,1,13,10,14
"2011","Greenwich 025","E02000337","Total",2998,1390,463,927,36,1275,1067,208,265,246,1,16,2,32
"2011","Greenwich 027","E02000339","Total",2502,1716,807,909,1,499,290,209,237,221,0,12,4,49
"2011","Greenwich 028","E02000340","Total",2799,1879,975,904,18,412,333,79,450,412,5,30,3,40
"2011","Greenwich 029","E02000341","Total",3024,1209,437,772,9,1546,1408,138,232,200,4,22,6,28
"2011","Greenwich 030","E02000342","Total",2268,1154,485,669,58,723,538,185,312,276,0,12,24,21
"2011","Greenwich 031","E02000343","Total",2699,1501,658,843,7,935,808,127,228,212,2,11,3,28
"2011","Greenwich 032","E02000344","Total",2476,1885,826,1059,11,283,191,92,280,258,0,21,1,17
"2011","Greenwich 033","E02006786","Total",2599,1359,532,827,28,764,500,264,419,389,2,20,8,29
"2011","Greenwich 034","E02006927","Total",3338,1924,918,1006,27,930,767,163,422,398,3,18,3,35
"2011","Greenwich 035","E02006928","Total",2977,632,138,494,116,1247,741,506,941,906,0,30,5,41
"2011","Greenwich 036","E02006929","Total",3333,999,289,710,60,1309,691,618,930,883,3,31,13,35
"2011","Greenwich 037","E02006930","Total",2876,1286,459,827,28,592,339,253,935,897,3,23,12,35
"2011","Greenwich 038","E02006931","Total",4113,1634,606,1028,43,1286,800,486,1103,1043,20,33,7,47
"2011","Harrow 001","E02000433","Total",3309,2223,1355,868,53,364,109,255,603,566,8,22,7,66
"2011","Harrow 002","E02000434","Total",3138,2142,1116,1026,8,250,138,112,686,617,22,25,22,52
"2011","Harrow 003","E02000435","Total",2728,1706,885,821,19,527,402,125,430,322,60,12,36,46
"2011","Harrow 004","E02000436","Total",2080,1821,977,844,3,67,60,7,168,156,2,8,2,21
"2011","Harrow 005","E02000437","Total",3082,2235,1068,1167,33,316,148,168,475,440,2,32,1,23
"2011","Harrow 006","E02000438","Total",2990,1782,903,879,18,620,427,193,509,486,4,13,6,61
"2011","Harrow 007","E02000439","Total",2711,1693,809,884,10,318,281,37,647,609,4,28,6,43
"2011","Harrow 008","E02000440","Total",3087,2497,1109,1388,12,132,108,24,414,377,7,23,7,32
"2011","Harrow 009","E02000441","Total",2765,1781,933,848,21,541,426,115,384,367,2,13,2,38
"2011","Harrow 010","E02000442","Total",2532,1743,815,928,8,121,65,56,616,567,4,34,11,44
"2011","Harrow 011","E02000443","Total",3203,1746,734,1012,40,506,288,218,873,827,1,40,5,38
"2011","Harrow 012","E02000444","Total",2682,1914,877,1037,3,89,55,34,637,602,0,27,8,39
"2011","Harrow 013","E02000445","Total",3616,1917,821,1096,105,535,183,352,1023,982,4,22,15,36
"2011","Harrow 015","E02000447","Total",2453,1810,854,956,8,201,111,90,407,382,2,20,3,27
"2011","Harrow 016","E02000448","Total",2730,2039,1154,885,8,230,125,105,418,396,5,9,8,35
"2011","Harrow 017","E02000449","Total",2531,1465,734,731,19,452,329,123,551,527,5,11,8,44
"2011","Harrow 019","E02000451","Total",2341,1937,992,945,37,49,28,21,297,278,4,15,0,21
"2011","Harrow 020","E02000452","Total",3039,1486,630,856,34,133,21,112,1366,1325,8,27,6,20
"2011","Harrow 021","E02000453","Total",2800,1756,772,984,54,180,93,87,781,734,3,36,8,29
"2011","Harrow 022","E02000454","Total",2550,2214,1057,1157,1,93,74,19,222,206,0,13,3,20
"2011","Harrow 023","E02000455","Total",3306,1497,718,779,61,459,210,249,1224,1148,5,35,36,65
"2011","Harrow 024","E02000456","Total",2512,1589,684,905,36,244,165,79,609,585,2,17,5,34
"2011","Harrow 025","E02000457","Total",2200,1657,829,828,9,120,16,104,395,363,3,27,2,19
"2011","Harrow 027","E02000459","Total",3159,1533,666,867,70,622,395,227,891,843,2,32,14,43
"2011","Harrow 028","E02000460","Total",2189,1043,422,621,22,666,177,489,427,395,2,15,15,31
"2011","Harrow 029","E02000461","Total",2556,1424,642,782,37,128,108,20,840,768,41,25,6,127
"2011","Harrow 030","E02000462","Total",2210,1423,627,796,11,139,27,112,609,565,3,31,10,28
"2011","Harrow 031","E02000463","Total",2788,1672,611,1061,12,586,443,143,480,450,1,22,7,38
"2011","Harrow 032","E02006795","Total",2639,1923,844,1079,8,69,34,35,615,586,1,25,3,24
"2011","Harrow 033","E02006882","Total",4342,3333,1608,1725,61,166,111,55,727,696,3,22,6,55
"2011","Havering 001","E02000464","Total",2597,1551,741,810,30,817,733,84,174,161,2,11,0,25
"2011","Havering 002","E02000465","Total",3256,1701,626,1075,16,1234,1100,134,263,237,0,24,2,42
"2011","Havering 003","E02000466","Total",3235,2145,988,1157,20,797,660,137,230,206,1,18,5,43
"2011","Havering 004","E02000467","Total",4087,1615,542,1073,13,2103,1970,133,314,281,3,22,8,42
"2011","Havering 005","E02000468","Total",3099,2392,1129,1263,20,355,268,87,296,277,4,12,3,36
"2011","Havering 006","E02000469","Total",2664,1537,614,923,21,848,713,135,240,217,2,15,6,18
"2011","Havering 007","E02000470","Total",3487,2752,1388,1364,6,277,126,151,427,403,2,18,4,25
"2011","Havering 008","E02000471","Total",2961,2759,1516,1243,2,52,50,2,134,124,0,10,0,14
"2011","Havering 009","E02000472","Total",3544,2920,1365,1555,11,289,264,25,299,279,2,16,2,25
"2011","Havering 010","E02000473","Total",3841,3219,1469,1750,30,236,114,122,327,302,3,18,4,29
"2011","Havering 011","E02000474","Total",3514,2444,1035,1409,31,549,419,130,463,444,0,16,3,27
"2011","Havering 012","E02000475","Total",3933,2880,1399,1481,34,401,268,133,587,559,3,24,1,31
"2011","Havering 013","E02000476","Total",4023,1777,767,1010,162,988,480,508,1060,1013,3,39,5,36
"2011","Havering 014","E02000477","Total",3725,3243,1603,1640,8,108,66,42,349,323,3,22,1,17
"2011","Havering 015","E02000478","Total",2156,1939,1102,837,1,107,8,99,93,88,2,2,1,16
"2011","Havering 016","E02000479","Total",3529,2324,876,1448,22,357,300,57,797,764,2,28,3,29
"2011","Havering 017","E02000480","Total",3872,2648,1052,1596,19,567,367,200,609,565,2,31,11,29
"2011","Havering 018","E02000481","Total",3254,2748,1555,1193,9,249,236,13,215,193,4,17,1,33
"2011","Havering 019","E02000482","Total",2546,2349,1366,983,4,28,24,4,149,133,2,13,1,16
"2011","Havering 020","E02000483","Total",3423,2331,1244,1087,19,547,355,192,493,456,4,30,3,33
"2011","Havering 021","E02000484","Total",3180,2688,1225,1463,9,211,160,51,249,225,1,23,0,23
"2011","Havering 022","E02000485","Total",3375,2710,1338,1372,9,211,195,16,429,390,3,34,2,16
"2011","Havering 023","E02000486","Total",3039,2554,1295,1259,5,105,80,25,341,318,0,21,2,34
"2011","Havering 024","E02000487","Total",2970,2812,1574,1238,4,30,25,5,102,87,4,7,4,22
"2011","Havering 025","E02000488","Total",2967,2722,1449,1273,2,58,43,15,169,154,1,13,1,16
"2011","Havering 026","E02000489","Total",3155,2309,1109,1200,19,514,428,86,291,271,1,16,3,22
"2011","Havering 027","E02000490","Total",3169,2500,1275,1225,8,399,291,108,238,221,1,15,1,24
"2011","Havering 028","E02000491","Total",3603,2294,1056,1238,26,917,482,435,339,313,0,21,5,27
"2011","Havering 029","E02000492","Total",2524,2215,1269,946,8,85,31,54,201,185,1,12,3,15
"2011","Havering 030","E02000493","Total",2471,1620,658,962,18,360,208,152,459,412,4,38,5,14
"2011","Hillingdon 001","E02000494","Total",3115,2187,1239,948,11,433,107,326,444,390,26,10,18,40
"2011","Hillingdon 002","E02000495","Total",4141,2534,1320,1214,19,530,341,189,1005,945,14,36,10,53
"2011","Hillingdon 003","E02000496","Total",3008,1933,855,1078,12,723,601,122,307,269,13,18,7,33
"2011","Hillingdon 004","E02000497","Total",3440,2418,1131,1287,21,642,456,186,334,293,7,26,8,25
"2011","Hillingdon 005","E02000498","Total",2561,1896,880,1016,27,421,267,154,196,178,3,12,3,21
"2011","Hillingdon 006","E02000499","Total",3001,2493,1351,1142,6,164,138,26,318,289,3,19,7,20
"2011","Hillingdon 007","E02000500","Total",3093,2324,1271,1053,32,189,14,175,517,483,8,19,7,31
"2011","Hillingdon 008","E02000501","Total",3163,2592,1165,1427,7,232,127,105,306,286,3,16,1,26
"2011","Hillingdon 009","E02000502","Total",3097,2236,1001,1235,18,137,102,35,683,512,85,21,65,23
"2011","Hillingdon 010","E02000503","Total",3235,2685,1102,1583,30,116,43,73,381,276,48,25,32,23
"2011","Hillingdon 011","E02000504","Total",2891,2467,1305,1162,7,125,104,21,270,213,25,15,17,22
"2011","Hillingdon 013","E02000506","Total",2725,2300,1239,1061,5,137,36,101,262,235,12,7,8,21
"2011","Hillingdon 014","E02000507","Total",2756,2115,843,1272,17,278,219,59,324,309,2,11,2,22
"2011","Hillingdon 015","E02000508","Total",3075,1569,768,801,22,560,364,196,887,696,103,25,63,37
"2011","Hillingdon 016","E02000509","Total",3112,1438,598,840,57,744,557,187,834,790,5,28,11,39
"2011","Hillingdon 017","E02000510","Total",3196,2158,950,1208,24,412,175,237,565,538,6,15,6,37
"2011","Hillingdon 018","E02000511","Total",3211,2349,976,1373,81,261,152,109,490,462,5,17,6,30
"2011","Hillingdon 019","E02000512","Total",2968,1520,604,916,55,844,614,230,527,511,3,12,1,22
"2011","Hillingdon 020","E02000513","Total",3234,1578,521,1057,59,988,762,226,563,535,2,18,8,46
"2011","Hillingdon 021","E02000514","Total",3044,2041,850,1191,41,215,113,102,703,650,5,33,15,44
"2011","Hillingdon 022","E02000515","Total",4303,2100,768,1332,129,936,654,282,1110,1070,6,27,7,28
"2011","Hillingdon 023","E02000516","Total",2764,1606,600,1006,68,490,49,441,548,519,1,22,6,52
"2011","Hillingdon 024","E02000517","Total",2917,1498,510,988,44,806,584,222,533,513,3,13,4,36
"2011","Hillingdon 025","E02000518","Total",3099,1610,616,994,40,988,736,252,432,405,1,17,9,29
"2011","Hillingdon 026","E02000519","Total",2890,1229,449,780,65,1057,731,326,501,483,2,12,4,38
"2011","Hillingdon 027","E02000520","Total",3645,1846,682,1164,48,803,495,308,900,847,10,35,8,48
"2011","Hillingdon 028","E02000521","Total",3397,1642,620,1022,118,1053,503,550,560,531,2,22,5,24
"2011","Hillingdon 029","E02000522","Total",3269,1725,766,959,58,868,527,341,577,545,4,20,8,41
"2011","Hillingdon 030","E02000523","Total",2939,1760,718,1042,106,356,81,275,694,663,3,21,7,23
"2011","Hillingdon 031","E02000524","Total",2462,1308,631,677,14,306,127,179,801,764,13,15,9,33
"2011","Hillingdon 032","E02000525","Total",3142,1531,596,935,21,602,422,180,949,911,7,21,10,39
"2011","Hillingdon 033","E02006796","Total",3321,2323,996,1327,18,336,280,56,620,580,3,34,3,24
"2011","Hounslow 001","E02000526","Total",3536,1995,985,1010,7,398,188,210,1090,1048,6,32,4,46
"2011","Hounslow 003","E02000528","Total",4770,1460,571,889,202,2122,1655,467,935,894,4,26,11,51
"2011","Hounslow 004","E02000529","Total",2776,1471,605,866,35,593,413,180,640,606,3,24,7,37
"2011","Hounslow 005","E02000530","Total",2314,782,327,455,7,1134,972,162,340,319,1,18,2,51
"2011","Hounslow 006","E02000531","Total",4269,1952,786,1166,162,1107,798,309,979,928,4,35,12,69
"2011","Hounslow 007","E02000532","Total",4001,2224,1058,1166,17,906,684,222,791,756,4,26,5,63
"2011","Hounslow 008","E02000533","Total",3835,2032,881,1151,9,778,532,246,973,934,3,32,4,43
"2011","Hounslow 009","E02000534","Total",2917,1817,838,979,77,195,47,148,789,757,8,19,5,39
"2011","Hounslow 010","E02000535","Total",2852,1780,805,975,32,393,251,142,607,570,7,21,9,40
"2011","Hounslow 011","E02000536","Total",2925,1688,732,956,29,492,146,346,688,657,5,24,2,28
"2011","Hounslow 012","E02000537","Total",2841,1744,938,806,9,70,38,32,993,949,5,34,5,25
"2011","Hounslow 013","E02000538","Total",2648,1378,650,728,14,464,394,70,750,677,25,20,28,42
"2011","Hounslow 014","E02000539","Total",4299,2123,675,1448,153,1058,538,520,922,868,5,39,10,43
"2011","Hounslow 015","E02000540","Total",3564,1657,755,902,136,711,379,332,1022,973,4,29,16,38
"2011","Hounslow 016","E02000541","Total",2846,1131,574,557,28,966,371,595,666,637,1,16,12,55
"2011","Hounslow 017","E02000542","Total",3166,1274,562,712,102,775,563,212,979,934,3,19,23,36
"2011","Hounslow 018","E02000543","Total",4170,1642,691,951,173,571,275,296,1743,1684,9,34,16,41
"2011","Hounslow 019","E02000544","Total",2793,2051,907,1144,34,159,87,72,522,494,2,17,9,27
"2011","Hounslow 020","E02000545","Total",3299,1441,513,928,33,1214,1083,131,552,523,4,17,8,59
"2011","Hounslow 021","E02000546","Total",3018,1567,626,941,84,531,255,276,800,765,1,28,6,36
"2011","Hounslow 022","E02000547","Total",3547,2084,785,1299,39,757,640,117,618,573,5,31,9,49
"2011","Hounslow 023","E02000548","Total",3539,1424,522,902,347,1170,679,491,559,520,1,25,13,39
"2011","Hounslow 024","E02000549","Total",3937,2526,1056,1470,65,751,525,226,545,511,3,25,6,50
"2011","Hounslow 025","E02000550","Total",3840,1476,404,1072,233,1373,827,546,724,695,1,16,12,34
"2011","Hounslow 026","E02000551","Total",3294,1254,449,805,46,1577,945,632,363,336,0,22,5,54
"2011","Hounslow 027","E02000552","Total",3266,2032,678,1354,112,344,165,179,753,711,3,32,7,25
"2011","Hounslow 028","E02000553","Total",2605,1647,667,980,44,613,528,85,272,247,3,20,2,29
"2011","Hounslow 029","E02006792","Total",4035,1910,1008,902,16,460,318,142,1591,1533,7,37,14,58
"2011","Kingston upon Thames 001","E02000598","Total",3001,2339,1052,1287,27,227,76,151,381,357,2,20,2,27
"2011","Kingston upon Thames 002","E02000599","Total",2368,1853,1006,847,9,73,54,19,391,375,5,8,3,42
"2011","Kingston upon Thames 003","E02000600","Total",3354,1770,796,974,2,466,416,50,1073,1004,16,37,16,43
"2011","Kingston upon Thames 004","E02000601","Total",4245,2367,907,1460,48,577,338,239,1205,1058,68,28,51,48
"2011","Kingston upon Thames 005","E02000602","Total",3997,1576,573,1003,51,1313,1066,247,1007,940,16,44,7,50
"2011","Kingston upon Thames 006","E02000603","Total",2798,1460,573,887,50,697,477,220,560,517,0,33,10,31
"2011","Kingston upon Thames 007","E02000604","Total",3343,2162,1005,1157,21,214,177,37,902,854,4,27,17,44
"2011","Kingston upon Thames 008","E02000605","Total",3013,2274,1071,1203,12,168,142,26,529,496,5,21,7,30
"2011","Kingston upon Thames 009","E02000606","Total",4799,2390,1021,1369,24,322,142,180,2022,1918,10,48,46,41
"2011","Kingston upon Thames 010","E02000607","Total",2497,1672,717,955,4,202,140,62,594,565,5,19,5,25
"2011","Kingston upon Thames 011","E02000608","Total",3182,1498,543,955,20,312,93,219,1317,1258,8,40,11,35
"2011","Kingston upon Thames 012","E02000609","Total",2741,1954,964,990,15,392,345,47,357,329,3,19,6,23
"2011","Kingston upon Thames 013","E02000610","Total",3785,1720,731,989,18,660,442,218,1349,1303,1,38,7,38
"2011","Kingston upon Thames 014","E02000611","Total",2649,2367,1179,1188,17,56,42,14,195,185,1,6,3,14
"2011","Kingston upon Thames 015","E02000612","Total",3051,2543,1247,1296,3,141,102,39,333,317,1,14,1,31
"2011","Kingston upon Thames 016","E02000613","Total",3174,2084,809,1275,19,382,232,150,671,642,4,20,5,18
"2011","Kingston upon Thames 017","E02000614","Total",3072,2139,852,1287,39,278,205,73,594,540,10,29,15,22
"2011","Kingston upon Thames 018","E02000615","Total",2916,2314,1015,1299,13,231,195,36,328,296,4,24,4,30
"2011","Kingston upon Thames 019","E02000616","Total",2363,2006,766,1240,23,127,75,52,201,178,0,20,3,6
"2011","Kingston upon Thames 020","E02000617","Total",3291,2274,900,1374,19,664,493,171,303,259,9,30,5,31
"2011","Merton 001","E02000689","Total",3230,1994,868,1126,103,225,57,168,885,854,2,27,2,23
"2011","Merton 002","E02000690","Total",2300,1625,1047,578,3,182,37,145,430,400,8,19,3,60
"2011","Merton 003","E02000691","Total",2968,1557,666,891,35,262,62,200,1086,1046,2,30,8,28
"2011","Merton 004","E02000692","Total",3686,1871,1071,800,9,322,21,301,1416,1347,6,46,17,68
"2011","Merton 005","E02000693","Total",3973,1961,622,1339,44,334,66,268,1598,1526,8,53,11,36
"2011","Merton 006","E02000694","Total",3828,2058,752,1306,13,539,113,426,1188,1147,4,28,9,30
"2011","Merton 007","E02000695","Total",2813,1880,895,985,11,94,13,81,799,743,4,36,16,29
"2011","Merton 008","E02000696","Total",3185,1427,429,998,22,594,151,443,1115,1073,2,38,2,27
"2011","Merton 009","E02000697","Total",3577,1888,805,1083,13,149,27,122,1494,1431,11,50,2,33
"2011","Merton 010","E02000698","Total",3146,2294,1183,1111,8,162,43,119,644,608,9,24,3,38
"2011","Merton 011","E02000699","Total",3205,2064,858,1206,8,159,34,125,946,908,4,28,6,28
"2011","Merton 012","E02000700","Total",3367,1311,437,874,40,1135,323,812,851,805,1,32,13,30
"2011","Merton 013","E02000701","Total",3006,1618,626,992,64,484,109,375,805,754,4,35,12,35
"2011","Merton 014","E02000702","Total",2964,1645,598,1047,42,760,259,501,490,459,0,27,4,27
"2011","Merton 015","E02000703","Total",2961,2273,1204,1069,13,131,25,106,520,490,7,17,6,24
"2011","Merton 016","E02000704","Total",3409,1841,776,1065,5,480,149,331,1046,984,9,46,7,37
"2011","Merton 017","E02000705","Total",2836,2191,886,1305,28,130,22,108,464,437,1,23,3,23
"2011","Merton 018","E02000706","Total",3259,1233,411,822,50,1336,436,900,599,552,3,30,14,41
"2011","Merton 019","E02000707","Total",2683,1450,506,944,19,840,50,790,353,329,1,17,6,21
"2011","Merton 020","E02000708","Total",3011,2365,1043,1322,28,108,35,73,483,454,2,23,4,27
"2011","Merton 021","E02000709","Total",2874,2437,1222,1215,9,127,48,79,285,259,0,25,1,16
"2011","Merton 022","E02000710","Total",3208,1838,818,1020,46,690,188,502,607,572,2,28,5,27
"2011","Merton 023","E02000711","Total",3140,1635,649,986,10,697,286,411,767,721,4,30,12,31
"2011","Merton 024","E02000712","Total",3328,1780,706,1074,33,1092,307,785,389,353,1,23,12,34
"2011","Merton 025","E02000713","Total",2800,2453,1082,1371,15,70,26,44,243,226,2,14,1,19
"2011","Redbridge 001","E02000751","Total",4277,3485,1935,1550,12,190,78,112,536,505,5,22,4,54
"2011","Redbridge 002","E02000752","Total",2864,1561,666,895,20,938,745,193,298,275,3,16,4,47
"2011","Redbridge 003","E02000753","Total",2420,1498,605,893,41,503,400,103,350,323,0,26,1,28
"2011","Redbridge 004","E02000754","Total",2607,1785,738,1047,13,395,271,124,379,359,1,18,1,35
"2011","Redbridge 005","E02000755","Total",2151,1534,646,888,7,260,203,57,327,302,0,20,5,23
"2011","Redbridge 006","E02000756","Total",4966,3461,1495,1966,41,481,332,149,916,871,2,36,7,67
"2011","Redbridge 007","E02000757","Total",4969,3094,1338,1756,125,406,156,250,1295,1222,10,54,9,49
"2011","Redbridge 008","E02000758","Total",2159,1618,787,831,5,268,211,57,248,225,1,21,1,20
"2011","Redbridge 009","E02000759","Total",4703,3013,1176,1837,14,750,557,193,881,829,2,42,8,45
"2011","Redbridge 010","E02000760","Total",2613,1665,788,877,28,445,248,197,444,417,2,20,5,31
"2011","Redbridge 012","E02000762","Total",2087,1699,824,875,3,74,61,13,293,263,4,22,4,18
"2011","Redbridge 013","E02000763","Total",2385,1593,672,921,41,311,201,110,413,385,0,27,1,27
"2011","Redbridge 014","E02000764","Total",5435,3376,1651,1725,22,640,287,353,1326,1251,7,58,10,71
"2011","Redbridge 015","E02000765","Total",2190,1496,713,783,8,128,64,64,532,502,2,22,6,26
"2011","Redbridge 017","E02000767","Total",2620,1675,730,945,74,254,140,114,593,555,5,26,7,24
"2011","Redbridge 018","E02000768","Total",2240,1657,838,819,2,276,92,184,284,261,2,18,3,21
"2011","Redbridge 019","E02000769","Total",5160,3368,1340,2028,116,516,166,350,1099,1049,1,38,11,61
"2011","Redbridge 020","E02000770","Total",2425,1521,664,857,14,164,89,75,700,663,1,24,12,26
"2011","Redbridge 022","E02000772","Total",2565,1452,549,903,31,287,83,204,764,727,3,26,8,31
"2011","Redbridge 023","E02000773","Total",2819,1674,643,1031,76,359,75,284,685,661,5,11,8,25
"2011","Redbridge 024","E02000774","Total",2208,1272,571,701,5,104,55,49,795,755,1,32,7,32
"2011","Redbridge 026","E02000776","Total",2031,1189,582,607,9,109,42,67,694,661,2,25,6,30
"2011","Redbridge 027","E02000777","Total",2365,1635,742,893,9,383,254,129,317,293,2,18,4,21
"2011","Redbridge 029","E02000779","Total",2753,1054,470,584,14,318,176,142,1325,1297,3,22,3,42
"2011","Redbridge 030","E02000780","Total",4443,2013,891,1122,73,477,287,190,1820,1741,5,58,16,60
"2011","Redbridge 031","E02000781","Total",4257,3050,1302,1748,43,325,177,148,799,745,2,38,14,40
"2011","Redbridge 032","E02000782","Total",2851,1137,479,658,87,559,199,360,1026,984,2,26,14,42
"2011","Redbridge 033","E02000783","Total",2250,959,367,592,20,602,229,373,641,594,5,31,11,28
"2011","Redbridge 034","E02006800","Total",4170,2388,992,1396,34,355,185,170,1338,1268,5,52,13,55
"2011","Redbridge 035","E02006924","Total",4020,2748,1216,1532,7,213,85,128,1007,969,2,26,10,45
"2011","Redbridge 036","E02006925","Total",4102,3313,1501,1812,9,199,121,78,532,489,0,40,3,49
"2011","Richmond upon Thames 001","E02000784","Total",4296,2470,1366,1104,12,771,230,541,975,924,16,29,6,68
"2011","Richmond upon Thames 002","E02000785","Total",4304,2748,1483,1265,11,271,41,230,1226,1180,13,29,4,48
"2011","Richmond upon Thames 003","E02000786","Total",4941,2870,1308,1562,26,790,212,578,1199,1121,4,64,10,56
"2011","Richmond upon Thames 004","E02000787","Total",4800,2472,1033,1439,87,970,214,756,1199,1145,10,33,11,72
"2011","Richmond upon Thames 005","E02000788","Total",3666,2439,1123,1316,5,327,69,258,852,808,4,37,3,43
"2011","Richmond upon Thames 006","E02000789","Total",2966,1489,777,712,7,583,32,551,853,821,4,19,9,34
"2011","Richmond upon Thames 007","E02000790","Total",2609,1762,745,1017,29,104,10,94,678,647,1,29,1,36
"2011","Richmond upon Thames 008","E02000791","Total",2986,1506,845,661,15,218,14,204,1187,1133,16,27,11,60
"2011","Richmond upon Thames 009","E02000792","Total",3209,1887,875,1012,6,183,28,155,1084,1048,6,24,6,49
"2011","Richmond upon Thames 010","E02000793","Total",3144,2216,1024,1192,26,364,86,278,505,434,25,27,19,33
"2011","Richmond upon Thames 011","E02000794","Total",2660,1971,868,1103,31,91,23,68,542,512,4,22,4,25
"2011","Richmond upon Thames 012","E02000795","Total",2623,1966,1120,846,13,242,56,186,354,329,8,7,10,48
"2011","Richmond upon Thames 013","E02000796","Total",3918,2560,1251,1309,36,830,267,563,446,417,2,22,5,46
"2011","Richmond upon Thames 014","E02000797","Total",3273,2033,757,1276,31,197,30,167,975,923,10,38,4,37
"2011","Richmond upon Thames 015","E02000798","Total",4280,3068,1192,1876,18,493,162,331,656,613,7,31,5,45
"2011","Richmond upon Thames 016","E02000799","Total",2418,1730,810,920,4,186,53,133,466,433,1,27,5,32
"2011","Richmond upon Thames 017","E02000800","Total",2159,1298,613,685,22,535,196,339,267,248,3,10,6,37
"2011","Richmond upon Thames 018","E02000801","Total",2880,2091,888,1203,31,138,27,111,598,565,3,25,5,22
"2011","Richmond upon Thames 019","E02000802","Total",2840,2027,890,1137,4,241,46,195,549,509,7,20,13,19
"2011","Richmond upon Thames 020","E02000803","Total",4086,2537,1205,1332,78,918,245,673,506,462,6,31,7,47
"2011","Richmond upon Thames 021","E02000804","Total",3148,1987,915,1072,17,354,85,269,767,732,7,22,6,23
"2011","Richmond upon Thames 022","E02000805","Total",4455,2778,1333,1445,46,671,161,510,898,806,8,40,44,62
"2011","Richmond upon Thames 023","E02000806","Total",4174,2845,1335,1510,46,574,164,410,658,600,11,30,17,51
"2011","Sutton 001","E02000840","Total",3206,1353,353,1000,25,1497,1144,353,302,281,0,16,5,29
"2011","Sutton 002","E02000841","Total",3335,1442,411,1031,64,1386,1199,187,426,403,0,17,6,17
"2011","Sutton 003","E02000842","Total",2879,2390,1097,1293,13,138,53,85,315,293,1,20,1,23
"2011","Sutton 004","E02000843","Total",3271,2116,703,1413,46,464,359,105,626,588,4,30,4,19
"2011","Sutton 005","E02000844","Total",3117,2046,698,1348,15,696,476,220,339,310,1,21,7,21
"2011","Sutton 006","E02000845","Total",3472,2545,938,1607,20,258,83,175,626,592,2,29,3,23
"2011","Sutton 007","E02000846","Total",2708,2144,907,1237,14,196,97,99,333,292,10,28,3,21
"2011","Sutton 008","E02000847","Total",3489,2969,1469,1500,15,156,22,134,326,292,2,32,0,23
"2011","Sutton 009","E02000848","Total",2886,2544,1089,1455,5,37,16,21,285,262,3,18,2,15
"2011","Sutton 010","E02000849","Total",3099,2124,823,1301,35,483,276,207,438,410,2,22,4,19
"2011","Sutton 011","E02000850","Total",4037,3224,1267,1957,13,365,241,124,409,375,5,25,4,26
"2011","Sutton 012","E02000851","Total",4098,1944,777,1167,112,1047,725,322,956,917,6,24,9,39
"2011","Sutton 013","E02000852","Total",3136,2343,892,1451,16,198,58,140,567,524,1,36,6,12
"2011","Sutton 014","E02000853","Total",3164,2269,812,1457,15,333,224,109,533,500,0,30,3,14
"2011","Sutton 015","E02000854","Total",2932,2186,957,1229,5,246,99,147,476,446,6,22,2,19
"2011","Sutton 016","E02000855","Total",3035,2467,1184,1283,4,98,59,39,436,406,6,24,0,30
"2011","Sutton 017","E02000856","Total",3486,2467,1016,1451,23,222,66,156,751,716,2,27,6,23
"2011","Sutton 018","E02000857","Total",4004,2235,1024,1211,13,287,107,180,1442,1380,4,53,5,27
"2011","Sutton 019","E02000858","Total",3139,1035,389,646,116,1721,340,1381,237,218,3,15,1,30
"2011","Sutton 020","E02000859","Total",3453,2479,1242,1237,5,478,171,307,456,434,2,17,3,35
"2011","Sutton 021","E02000860","Total",3925,1764,777,987,5,773,327,446,1347,1287,1,50,9,36
"2011","Sutton 022","E02000861","Total",2789,2452,1256,1196,3,85,71,14,229,222,2,4,1,20
"2011","Sutton 024","E02000863","Total",2319,1930,885,1045,9,208,195,13,161,134,11,11,5,11
"2011","Sutton 025","E02006836","Total",3195,2684,1391,1293,20,50,13,37,413,389,2,18,4,28
"2011","Waltham Forest 001","E02000895","Total",3271,2181,1111,1070,27,738,328,410,290,263,4,16,7,35
"2011","Waltham Forest 002","E02000896","Total",3758,2736,1384,1352,12,385,161,224,588,553,11,23,1,37
"2011","Waltham Forest 003","E02000897","Total",3345,1986,919,1067,17,997,842,155,314,292,2,17,3,31
"2011","Waltham Forest 004","E02000898","Total",3065,2064,908,1156,32,689,296,393,256,236,1,15,4,24
"2011","Waltham Forest 005","E02000899","Total",3090,2309,1075,1234,11,348,181,167,403,372,4,24,3,19
"2011","Waltham Forest 006","E02000900","Total",2986,1964,845,1119,10,581,195,386,393,363,3,20,7,38
"2011","Waltham Forest 007","E02000901","Total",3553,2613,1088,1525,34,408,330,78,471,442,2,21,6,27
"2011","Waltham Forest 008","E02000902","Total",3101,1907,757,1150,22,621,390,231,510,487,0,14,9,41
"2011","Waltham Forest 009","E02000903","Total",3179,1368,426,942,28,1183,769,414,551,518,3,21,9,49
"2011","Waltham Forest 010","E02000904","Total",2900,1776,646,1130,46,402,137,265,661,622,4,30,5,15
"2011","Waltham Forest 011","E02000905","Total",3465,1839,619,1220,48,622,232,390,916,865,2,33,16,40
"2011","Waltham Forest 012","E02000906","Total",3507,1665,552,1113,27,825,352,473,952,907,1,37,7,38
"2011","Waltham Forest 013","E02000907","Total",3885,1181,410,771,27,1827,1417,410,794,751,3,21,19,56
"2011","Waltham Forest 014","E02000908","Total",4348,1899,558,1341,102,960,385,575,1341,1285,1,38,17,46
"2011","Waltham Forest 015","E02000909","Total",3459,1792,658,1134,34,662,396,266,932,880,17,24,11,39
"2011","Waltham Forest 016","E02000910","Total",4005,1856,713,1143,39,611,271,340,1448,1384,4,36,24,51
"2011","Waltham Forest 017","E02000911","Total",4115,1671,579,1092,79,902,521,381,1424,1375,6,32,11,39
"2011","Waltham Forest 018","E02000912","Total",3151,1474,578,896,56,780,371,409,811,772,1,29,9,30
"2011","Waltham Forest 019","E02000913","Total",2968,1644,777,867,36,362,82,280,893,853,2,23,15,33
"2011","Waltham Forest 020","E02000914","Total",3689,1153,484,669,51,1326,393,933,1118,1057,7,29,25,41
"2011","Waltham Forest 021","E02000915","Total",3305,1468,608,860,19,600,91,509,1190,1146,3,32,9,28
"2011","Waltham Forest 022","E02000916","Total",3506,1644,538,1106,64,464,182,282,1297,1239,1,44,13,37
"2011","Waltham Forest 023","E02000917","Total",3396,1524,530,994,15,362,75,287,1473,1430,1,33,9,22
"2011","Waltham Forest 024","E02000918","Total",3449,1312,502,810,74,944,593,351,1076,1029,6,32,9,43
"2011","Waltham Forest 025","E02000919","Total",3225,1474,640,834,14,332,54,278,1371,1321,4,31,15,34
"2011","Waltham Forest 026","E02000920","Total",3434,1144,528,616,58,1074,202,872,1126,1083,5,23,15,32
"2011","Waltham Forest 027","E02000921","Total",3966,1081,405,676,19,1647,794,853,1190,1147,2,28,13,29
"2011","Waltham Forest 028","E02000922","Total",3740,1636,558,1078,17,724,361,363,1313,1247,4,54,8,50
"2011","Bracknell Forest 001","E02003352","Total",2487,2096,1189,907,23,73,23,50,263,229,16,12,6,32
"2011","Bracknell Forest 002","E02003353","Total",3534,2672,974,1698,37,229,52,177,553,478,22,35,18,43
"2011","Bracknell Forest 003","E02003354","Total",3872,3025,948,2077,38,357,96,261,426,394,2,26,4,26
"2011","Bracknell Forest 004","E02003355","Total",2708,1365,483,882,71,1002,353,649,246,212,5,26,3,24
"2011","Bracknell Forest 005","E02003356","Total",2731,2154,930,1224,5,138,57,81,377,344,10,17,6,57
"2011","Bracknell Forest 006","E02003357","Total",3951,2031,700,1331,62,1240,442,798,560,510,5,42,3,58
"2011","Bracknell Forest 007","E02003358","Total",3988,2017,750,1267,87,1314,320,994,522,469,12,31,10,48
"2011","Bracknell Forest 008","E02003359","Total",2835,1765,355,1410,42,474,205,269,537,505,1,30,1,17
"2011","Bracknell Forest 009","E02003360","Total",3605,2473,748,1725,60,778,311,467,275,239,7,23,6,19
"2011","Bracknell Forest 010","E02003361","Total",3133,1989,569,1420,17,738,282,456,367,331,2,30,4,22
"2011","Bracknell Forest 011","E02003362","Total",2757,1888,600,1288,10,536,213,323,305,266,3,35,1,18
"2011","Bracknell Forest 012","E02003363","Total",2533,1874,953,921,42,125,48,77,383,267,87,9,20,109
"2011","Bracknell Forest 013","E02003364","Total",2509,2013,633,1380,6,271,72,199,210,175,7,22,6,9
"2011","Bracknell Forest 014","E02003365","Total",2652,2130,874,1256,14,230,73,157,258,228,6,19,5,20
"2011","Bracknell Forest 015","E02003366","Total",2583,1927,714,1213,13,173,53,120,452,227,113,27,85,18
"2011","Brighton and Hove 001","E02003491","Total",3088,2413,1126,1287,10,383,336,47,249,217,4,27,1,33
"2011","Brighton and Hove 002","E02003492","Total",2166,900,434,466,6,914,790,124,321,294,4,11,12,25
"2011","Brighton and Hove 003","E02003493","Total",3348,2661,1382,1279,13,199,100,99,439,411,2,24,2,36
"2011","Brighton and Hove 004","E02003494","Total",2641,2100,1024,1076,8,206,163,43,299,273,2,22,2,28
"2011","Brighton and Hove 005","E02003495","Total",2970,2140,895,1245,26,490,185,305,281,252,0,24,5,33
"2011","Brighton and Hove 006","E02003496","Total",3146,1983,1042,941,7,805,747,58,294,268,2,19,5,57
"2011","Brighton and Hove 007","E02003497","Total",2804,2358,1158,1200,3,45,19,26,376,354,2,16,4,22
"2011","Brighton and Hove 008","E02003498","Total",3475,1188,570,618,32,1597,1209,388,591,543,0,39,9,67
"2011","Brighton and Hove 009","E02003499","Total",2843,1066,496,570,44,1269,772,497,427,393,0,25,9,37
"2011","Brighton and Hove 010","E02003500","Total",3049,2310,834,1476,8,76,19,57,638,614,3,19,2,17
"2011","Brighton and Hove 011","E02003501","Total",3685,2499,1121,1378,17,92,29,63,1026,971,5,48,2,51
"2011","Brighton and Hove 012","E02003502","Total",3145,2053,824,1229,36,619,442,177,400,351,8,39,2,37
"2011","Brighton and Hove 013","E02003503","Total",3487,2336,1077,1259,17,738,462,276,359,336,3,18,2,37
"2011","Brighton and Hove 014","E02003504","Total",3838,2067,755,1312,120,309,106,203,1312,1243,1,58,10,30
"2011","Brighton and Hove 015","E02003505","Total",3786,1634,544,1090,21,319,156,163,1767,1674,1,80,12,45
"2011","Brighton and Hove 016","E02003506","Total",2871,1816,594,1222,20,209,105,104,795,753,1,39,2,31
"2011","Brighton and Hove 017","E02003507","Total",3924,2845,1455,1390,30,664,474,190,343,300,2,38,3,42
"2011","Brighton and Hove 018","E02003508","Total",3418,2039,800,1239,40,146,79,67,1168,1108,2,49,9,25
"2011","Brighton and Hove 019","E02003509","Total",4695,1904,708,1196,42,492,377,115,2198,2124,4,63,7,59
"2011","Brighton and Hove 020","E02003510","Total",4055,2292,1021,1271,41,151,15,136,1511,1447,5,55,4,60
"2011","Brighton and Hove 021","E02003511","Total",3318,2217,881,1336,36,299,191,108,725,681,0,41,3,41
"2011","Brighton and Hove 022","E02003512","Total",3736,1885,631,1254,19,439,177,262,1356,1285,3,64,4,37
"2011","Brighton and Hove 023","E02003513","Total",2907,1680,765,915,23,473,319,154,680,639,0,40,1,51
"2011","Brighton and Hove 024","E02003514","Total",4856,1871,652,1219,22,262,55,207,2659,2559,6,92,2,42
"2011","Brighton and Hove 025","E02003515","Total",3659,923,426,497,25,2406,1937,469,230,209,0,15,6,75
"2011","Brighton and Hove 026","E02003516","Total",4972,1871,701,1170,14,169,39,130,2875,2797,8,60,10,43
"2011","Brighton and Hove 027","E02003517","Total",5238,1712,729,983,146,760,305,455,2532,2391,22,93,26,88
"2011","Brighton and Hove 028","E02003518","Total",4158,2019,984,1035,33,199,23,176,1839,1749,6,72,12,68
"2011","Brighton and Hove 029","E02003519","Total",5052,1647,616,1031,20,348,27,321,2985,2867,7,96,15,52
"2011","Brighton and Hove 030","E02003520","Total",4690,1284,532,752,47,1354,1047,307,1922,1833,3,69,17,83
"2011","Brighton and Hove 031","E02003521","Total",4424,1753,748,1005,30,986,678,308,1556,1464,18,62,12,99
"2011","Brighton and Hove 032","E02003522","Total",3584,1646,774,872,14,636,495,141,1225,1153,4,62,6,63
"2011","Brighton and Hove 033","E02003523","Total",4512,3678,2098,1580,75,133,50,83,581,528,3,42,8,45
"2011","Isle of Wight 001","E02003581","Total",3669,2313,1097,1216,13,293,20,273,991,921,6,56,8,59
"2011","Isle of Wight 002","E02003582","Total",3516,2912,1681,1231,11,181,11,170,369,319,4,45,1,43
"2011","Isle of Wight 003","E02003583","Total",2847,1931,1117,814,36,477,45,432,385,351,4,23,7,18
"2011","Isle of Wight 004","E02003584","Total",3149,1550,778,772,3,202,18,184,1347,1298,5,40,4,47
"2011","Isle of Wight 005","E02003585","Total",3018,2455,1550,905,57,132,8,124,343,295,12,32,4,31
"2011","Isle of Wight 006","E02003586","Total",3268,2357,1288,1069,18,391,41,350,472,426,2,35,9,30
"2011","Isle of Wight 007","E02003587","Total",3610,2190,1138,1052,19,639,76,563,726,667,1,51,7,36
"2011","Isle of Wight 008","E02003588","Total",2917,1922,1007,915,11,592,70,522,360,315,4,39,2,32
"2011","Isle of Wight 009","E02003589","Total",3320,1829,808,1021,13,532,73,459,927,846,12,62,7,19
"2011","Isle of Wight 010","E02003590","Total",3549,2899,2054,845,13,151,7,144,413,363,9,37,4,73
"2011","Isle of Wight 011","E02003591","Total",3750,2762,1428,1334,27,422,56,366,496,450,5,37,4,43
"2011","Isle of Wight 012","E02003592","Total",4475,3289,2310,979,19,482,32,450,625,560,3,52,10,60
"2011","Isle of Wight 013","E02003593","Total",2350,1962,1250,712,7,124,1,123,219,175,7,26,11,38
"2011","Isle of Wight 014","E02003594","Total",3910,2552,1388,1164,80,425,38,387,803,723,4,70,6,50
"2011","Isle of Wight 015","E02003595","Total",3613,3002,1856,1146,6,238,8,230,336,286,2,46,2,31
"2011","Isle of Wight 016","E02003596","Total",4020,2504,1542,962,13,518,46,472,934,861,2,68,3,51
"2011","Isle of Wight 017","E02003597","Total",2464,1905,1199,706,5,248,18,230,267,233,6,25,3,39
"2011","Isle of Wight 018","E02003598","Total",3640,2483,1600,883,11,476,30,446,626,574,6,38,8,44
"2011","Medway 001","E02003314","Total",2724,2131,1181,950,39,268,34,234,248,214,3,24,7,38
"2011","Medway 002","E02003315","Total",2137,1715,694,1021,12,190,17,173,196,180,2,11,3,24
"2011","Medway 003","E02003316","Total",3873,2931,1276,1655,95,500,47,453,315,266,14,25,10,32
"2011","Medway 004","E02003317","Total",2321,1798,782,1016,26,272,28,244,204,182,1,16,5,21
"2011","Medway 005","E02003318","Total",2273,1992,999,993,20,90,4,86,159,142,2,12,3,12
"2011","Medway 006","E02003319","Total",3181,1956,786,1170,41,325,43,282,818,773,4,35,6,41
"2011","Medway 007","E02003320","Total",3127,1421,458,963,63,618,208,410,1000,772,123,25,80,25
"2011","Medway 008","E02003321","Total",2481,1480,667,813,32,699,101,598,238,212,1,21,4,32
"2011","Medway 009","E02003322","Total",2546,1296,449,847,16,345,228,117,874,828,1,35,10,15
"2011","Medway 010","E02003323","Total",2783,1555,530,1025,95,619,291,328,499,467,0,27,5,15
"2011","Medway 011","E02003324","Total",3572,2483,851,1632,87,520,64,456,450,421,2,21,6,32
"2011","Medway 012","E02003325","Total",3079,1342,500,842,36,510,329,181,1146,1089,6,44,7,45
"2011","Medway 013","E02003326","Total",2992,2050,815,1235,22,208,128,80,683,636,6,34,7,29
"2011","Medway 014","E02003327","Total",3518,1558,596,962,16,822,70,752,1025,957,12,37,19,97
"2011","Medway 015","E02003328","Total",3580,1279,539,740,29,863,115,748,1355,1199,58,33,65,54
"2011","Medway 016","E02003329","Total",2637,1571,585,986,6,47,18,29,992,941,9,37,5,21
"2011","Medway 017","E02003330","Total",2771,1786,744,1042,69,370,41,329,518,484,1,28,5,28
"2011","Medway 018","E02003331","Total",3674,2346,1034,1312,12,947,784,163,300,266,2,27,5,69
"2011","Medway 019","E02003332","Total",2238,1678,730,948,5,282,218,64,257,243,2,9,3,16
"2011","Medway 020","E02003333","Total",2900,1301,469,832,34,474,61,413,1055,1006,7,29,13,36
"2011","Medway 021","E02003334","Total",2254,1404,602,802,15,178,30,148,635,601,2,28,4,22
"2011","Medway 022","E02003335","Total",2719,1383,488,895,30,501,93,408,783,751,3,20,9,22
"2011","Medway 023","E02003336","Total",2454,2138,1180,958,8,126,116,10,157,144,0,10,3,25
"2011","Medway 024","E02003337","Total",2647,1861,857,1004,28,432,47,385,295,260,5,27,3,31
"2011","Medway 025","E02003338","Total",3078,2004,926,1078,8,470,276,194,565,532,2,28,3,31
"2011","Medway 026","E02003339","Total",2414,1880,919,961,16,256,38,218,235,208,1,23,3,27
"2011","Medway 027","E02003340","Total",3190,1921,806,1115,26,897,127,770,306,282,3,19,2,40
"2011","Medway 028","E02003341","Total",2211,1811,790,1021,33,153,18,135,199,180,2,12,5,15
"2011","Medway 029","E02003342","Total",2567,2108,1064,1044,5,172,157,15,257,232,1,22,2,25
"2011","Medway 030","E02003343","Total",2334,2151,1153,998,8,50,42,8,108,96,2,8,2,17
"2011","Medway 031","E02003344","Total",2725,1748,575,1173,29,651,94,557,266,242,1,16,7,31
"2011","Medway 032","E02003345","Total",2308,2004,711,1293,8,16,3,13,268,246,0,22,0,12
"2011","Medway 033","E02003346","Total",2540,2032,1051,981,11,243,36,207,236,210,2,23,1,18
"2011","Medway 034","E02003347","Total",2425,1927,459,1468,41,85,13,72,364,327,0,34,3,8
"2011","Medway 035","E02003348","Total",3139,2876,1457,1419,5,21,5,16,221,201,0,18,2,16
"2011","Medway 036","E02003349","Total",3091,2529,1153,1376,13,161,117,44,356,318,3,32,3,32
"2011","Medway 037","E02003350","Total",2521,1905,862,1043,24,389,84,305,181,163,2,13,3,22
"2011","Medway 038","E02003351","Total",3185,2502,959,1543,51,226,30,196,389,356,2,28,3,17
"2011","Milton Keynes 001","E02003459","Total",3670,2712,1265,1447,14,253,192,61,650,611,6,28,5,41
"2011","Milton Keynes 002","E02003460","Total",3806,2836,1296,1540,63,453,259,194,400,353,9,31,7,54
"2011","Milton Keynes 003","E02003461","Total",2925,2319,1047,1272,25,231,183,48,332,293,1,36,2,18
"2011","Milton Keynes 004","E02003462","Total",3289,2458,983,1475,60,170,126,44,576,525,8,34,9,25
"2011","Milton Keynes 005","E02003463","Total",2669,1791,731,1060,155,395,315,80,307,288,3,16,0,21
"2011","Milton Keynes 006","E02003464","Total",2569,1340,522,818,99,732,564,168,366,346,0,17,3,32
"2011","Milton Keynes 007","E02003465","Total",2685,1703,675,1028,389,253,146,107,318,292,4,19,3,22
"2011","Milton Keynes 008","E02003466","Total",2905,1782,614,1168,56,375,299,76,658,599,3,46,10,34
"2011","Milton Keynes 009","E02003467","Total",2490,1191,434,757,19,764,454,310,493,452,3,30,8,23
"2011","Milton Keynes 010","E02003468","Total",3191,2201,1027,1174,92,311,233,78,555,482,5,65,3,32
"2011","Milton Keynes 011","E02003469","Total",2406,1751,702,1049,140,159,140,19,336,310,1,23,2,20
"2011","Milton Keynes 012","E02003470","Total",2134,747,214,533,48,1027,827,200,277,251,2,22,2,35
"2011","Milton Keynes 013","E02003471","Total",2543,1226,431,795,161,664,403,261,473,425,1,41,6,19
"2011","Milton Keynes 014","E02003472","Total",3815,928,286,642,294,986,637,349,1560,1495,4,44,17,47
"2011","Milton Keynes 015","E02003473","Total",2335,1393,527,866,336,66,50,16,531,490,2,35,4,9
"2011","Milton Keynes 016","E02003474","Total",3238,1876,633,1243,172,561,199,362,608,580,3,21,4,21
"2011","Milton Keynes 017","E02003475","Total",5668,2930,672,2258,709,681,35,646,1327,1268,8,41,10,21
"2011","Milton Keynes 018","E02003476","Total",3080,1048,330,718,84,1191,873,318,723,681,5,29,8,34
"2011","Milton Keynes 019","E02003477","Total",4114,2606,760,1846,439,448,93,355,591,554,1,34,2,30
"2011","Milton Keynes 020","E02003478","Total",2684,1511,504,1007,348,339,114,225,473,452,1,15,5,13
"2011","Milton Keynes 021","E02003479","Total",2778,914,251,663,251,868,356,512,716,685,9,14,8,29
"2011","Milton Keynes 022","E02003480","Total",3402,1650,454,1196,477,607,13,594,651,629,5,16,1,17
"2011","Milton Keynes 023","E02003481","Total",3000,974,401,573,79,1504,1192,312,410,382,5,18,5,33
"2011","Milton Keynes 024","E02003482","Total",2508,1885,841,1044,71,180,143,37,352,323,2,23,4,20
"2011","Milton Keynes 025","E02003483","Total",3888,2344,427,1917,280,600,68,532,644,607,3,28,6,20
"2011","Milton Keynes 026","E02003484","Total",2914,1512,484,1028,374,554,117,437,455,424,0,24,7,19
"2011","Milton Keynes 027","E02003485","Total",3243,2067,908,1159,49,749,669,80,344,317,0,22,5,34
"2011","Milton Keynes 028","E02003486","Total",3410,2149,514,1635,417,307,52,255,527,496,0,28,3,10
"2011","Milton Keynes 029","E02003487","Total",2930,2011,958,1053,35,571,541,30,283,259,2,22,0,30
"2011","Milton Keynes 030","E02003488","Total",2881,1936,976,960,54,414,351,63,443,416,3,21,3,34
"2011","Milton Keynes 031","E02003489","Total",2824,2028,908,1120,146,260,191,69,361,336,2,21,2,29
"2011","Milton Keynes 032","E02003490","Total",2590,1094,382,712,49,1090,966,124,326,309,0,11,6,31
"2011","Portsmouth 001","E02003524","Total",3076,1514,554,960,36,1259,1081,178,227,202,0,20,5,40
"2011","Portsmouth 002","E02003525","Total",2459,1063,457,606,3,1025,776,249,329,285,13,24,7,39
"2011","Portsmouth 003","E02003526","Total",2687,2326,1405,921,22,102,29,73,213,178,23,9,3,24
"2011","Portsmouth 004","E02003527","Total",2571,1639,761,878,6,443,289,154,449,344,53,23,29,34
"2011","Portsmouth 006","E02003529","Total",3027,2448,1125,1323,7,262,177,85,284,253,2,26,3,26
"2011","Portsmouth 007","E02003530","Total",3101,1843,824,1019,24,672,283,389,530,349,96,27,58,32
"2011","Portsmouth 008","E02003531","Total",3314,2699,1187,1512,11,97,10,87,480,433,1,41,5,27
"2011","Portsmouth 009","E02003532","Total",3149,2094,766,1328,9,198,37,161,819,758,2,53,6,29
"2011","Portsmouth 010","E02003533","Total",2408,1434,529,905,16,397,275,122,530,484,1,43,2,31
"2011","Portsmouth 011","E02003534","Total",3469,2531,969,1562,20,107,52,55,775,712,1,54,8,36
"2011","Portsmouth 012","E02003535","Total",3810,2463,798,1665,33,212,37,175,1075,992,4,66,13,27
"2011","Portsmouth 013","E02003536","Total",3277,657,241,416,40,2179,1891,288,331,308,3,13,7,70
"2011","Portsmouth 014","E02003537","Total",4182,3039,1327,1712,76,493,245,248,538,469,2,59,8,36
"2011","Portsmouth 015","E02003538","Total",4386,2268,752,1516,48,617,285,332,1398,1283,5,102,8,55
"2011","Portsmouth 016","E02003539","Total",4872,752,299,453,147,3053,2024,1029,821,752,12,31,26,99
"2011","Portsmouth 017","E02003540","Total",3685,2638,1232,1406,35,384,173,211,583,517,4,55,7,45
"2011","Portsmouth 018","E02003541","Total",4631,956,493,463,39,2225,1820,405,1318,1256,6,44,12,93
"2011","Portsmouth 019","E02003542","Total",3669,1995,885,1110,19,196,38,158,1427,1331,8,82,6,32
"2011","Portsmouth 020","E02003543","Total",3503,1565,681,884,20,219,72,147,1668,1558,6,83,21,31
"2011","Portsmouth 021","E02003544","Total",2851,1765,704,1061,22,211,62,149,833,768,4,51,10,20
"2011","Portsmouth 022","E02003545","Total",3555,1340,627,713,25,528,101,427,1612,1529,14,47,22,50
"2011","Portsmouth 023","E02003546","Total",3825,2257,1102,1155,26,196,57,139,1303,1122,81,39,61,43
"2011","Portsmouth 024","E02003547","Total",4470,2008,1149,859,83,324,86,238,1981,1795,66,70,50,74
"2011","Portsmouth 025","E02003548","Total",2866,1496,694,802,47,89,20,69,1204,1133,11,56,4,30
"2011","Portsmouth 026","E02006821","Total",2630,2107,1055,1052,11,123,81,42,370,233,91,17,29,19
"2011","Reading 001","E02003389","Total",3115,2624,1275,1349,42,109,24,85,320,284,2,29,5,20
"2011","Reading 002","E02003390","Total",2846,2634,1303,1331,7,32,8,24,162,148,2,11,1,11
"2011","Reading 003","E02003391","Total",3286,2619,1244,1375,20,250,169,81,365,335,7,21,2,32
"2011","Reading 004","E02003392","Total",3647,2021,811,1210,104,618,250,368,862,820,2,33,7,42
"2011","Reading 005","E02003393","Total",3186,2706,1216,1490,7,90,51,39,363,322,4,30,7,20
"2011","Reading 006","E02003394","Total",2927,1573,497,1076,72,872,759,113,364,338,2,20,4,46
"2011","Reading 007","E02003395","Total",3861,1851,583,1268,36,292,55,237,1662,1573,18,54,17,20
"2011","Reading 008","E02003396","Total",3995,2224,798,1426,98,424,92,332,1230,1175,5,46,4,19
"2011","Reading 009","E02003397","Total",3022,1972,892,1080,16,705,604,101,295,270,0,24,1,34
"2011","Reading 010","E02003398","Total",4040,1551,481,1070,75,660,351,309,1724,1634,2,75,13,30
"2011","Reading 011","E02003399","Total",5891,1522,464,1058,260,919,258,661,3130,3053,11,49,17,60
"2011","Reading 012","E02003400","Total",3052,1443,629,814,21,82,17,65,1479,1414,6,40,19,27
"2011","Reading 013","E02003401","Total",3682,1913,824,1089,35,658,454,204,1036,983,3,46,4,40
"2011","Reading 014","E02003402","Total",3725,1536,563,973,55,386,195,191,1716,1636,12,49,19,32
"2011","Reading 015","E02003403","Total",3582,2087,1011,1076,47,1044,812,232,355,329,5,18,3,49
"2011","Reading 016","E02003404","Total",2326,1107,536,571,22,721,555,166,436,362,6,17,51,40
"2011","Reading 017","E02003405","Total",3816,1423,436,987,157,1568,1031,537,609,572,4,27,6,59
"2011","Reading 018","E02003406","Total",2870,1673,659,1014,56,812,637,175,286,269,0,16,1,43
"2011","Slough 001","E02003407","Total",3648,1735,560,1175,53,1501,1210,291,332,296,3,31,2,27
"2011","Slough 002","E02003408","Total",3462,1991,824,1167,23,461,278,183,948,893,7,31,17,39
"2011","Slough 003","E02003409","Total",4198,2364,749,1615,41,898,689,209,867,830,1,28,8,28
"2011","Slough 004","E02003410","Total",3334,1749,640,1109,12,703,533,170,823,763,9,40,11,47
"2011","Slough 005","E02003411","Total",3759,1816,687,1129,19,1110,628,482,772,711,11,35,15,42
"2011","Slough 006","E02003412","Total",3641,2403,842,1561,29,487,344,143,685,655,0,26,4,37
"2011","Slough 007","E02003413","Total",3880,1851,770,1081,78,653,250,403,1256,1195,0,50,11,42
"2011","Slough 008","E02003414","Total",4589,2579,651,1928,93,787,373,414,1098,1052,5,40,1,32
"2011","Slough 009","E02003415","Total",4241,1550,534,1016,113,790,425,365,1717,1655,5,36,21,71
"2011","Slough 010","E02003416","Total",3106,2051,769,1282,14,332,255,77,675,652,2,21,0,34
"2011","Slough 011","E02003417","Total",3654,1827,784,1043,51,420,239,181,1314,1251,21,24,18,42
"2011","Slough 012","E02003418","Total",3445,1949,701,1248,52,987,916,71,435,408,3,20,4,22
"2011","Slough 013","E02003419","Total",3276,1686,604,1082,51,983,483,500,532,504,0,26,2,24
"2011","Slough 014","E02003420","Total",2533,1204,387,817,57,364,33,331,894,848,6,37,3,14
"2011","Southampton 001","E02003549","Total",2849,1768,920,848,19,320,234,86,714,569,4,31,110,28
"2011","Southampton 002","E02003550","Total",3216,2125,866,1259,38,677,527,150,355,321,0,33,1,21
"2011","Southampton 003","E02003551","Total",2256,969,445,524,38,879,290,589,345,300,1,22,22,25
"2011","Southampton 004","E02003552","Total",2646,1084,339,745,17,1256,1056,200,245,217,0,26,2,44
"2011","Southampton 005","E02003553","Total",2394,766,361,405,20,609,528,81,964,917,4,31,12,35
"2011","Southampton 006","E02003554","Total",2646,1667,868,799,11,385,309,76,557,520,3,27,7,26
"2011","Southampton 007","E02003555","Total",3140,1763,760,1003,18,972,831,141,350,325,2,23,0,37
"2011","Southampton 008","E02003556","Total",2471,1740,811,929,9,309,232,77,399,371,2,24,2,14
"2011","Southampton 009","E02003557","Total",2753,1445,839,606,8,203,50,153,1073,1007,6,47,13,24
"2011","Southampton 010","E02003558","Total",2924,1164,495,669,28,945,718,227,755,708,12,27,8,32
"2011","Southampton 011","E02003559","Total",3065,2351,1157,1194,36,183,76,107,464,439,1,19,5,31
"2011","Southampton 012","E02003560","Total",3040,1098,457,641,9,1627,1519,108,266,246,0,17,3,40
"2011","Southampton 013","E02003561","Total",3181,1081,481,600,24,626,302,324,1423,1370,2,43,8,27
"2011","Southampton 014","E02003562","Total",3636,2152,832,1320,56,332,94,238,1063,1007,5,47,4,33
"2011","Southampton 015","E02003563","Total",3483,1804,793,1011,43,759,555,204,842,794,0,38,10,35
"2011","Southampton 016","E02003564","Total",3474,2202,1059,1143,36,783,644,139,420,386,1,32,1,33
"2011","Southampton 017","E02003565","Total",2563,742,308,434,30,298,79,219,1467,1411,4,46,6,26
"2011","Southampton 018","E02003566","Total",2607,1549,747,802,32,778,587,191,218,198,0,18,2,30
"2011","Southampton 019","E02003567","Total",2991,1699,688,1011,23,816,716,100,422,386,1,31,4,31
"2011","Southampton 020","E02003568","Total",3820,1640,601,1039,29,173,22,151,1945,1880,4,51,10,33
"2011","Southampton 021","E02003569","Total",3527,1563,613,950,48,529,165,364,1350,1280,3,59,8,37
"2011","Southampton 022","E02003570","Total",3635,821,357,464,20,1084,621,463,1661,1603,4,36,18,49
"2011","Southampton 023","E02003571","Total",3040,653,305,348,5,615,256,359,1732,1676,11,35,10,35
"2011","Southampton 024","E02003572","Total",2484,1870,802,1068,13,202,158,44,384,351,2,27,4,15
"2011","Southampton 025","E02003573","Total",3236,1548,796,752,31,1409,1291,118,198,169,1,24,4,50
"2011","Southampton 026","E02003574","Total",3412,2447,1101,1346,65,402,299,103,466,425,1,38,2,32
"2011","Southampton 027","E02003575","Total",2808,1057,403,654,43,1436,1316,120,231,207,1,19,4,41
"2011","Southampton 028","E02003576","Total",3434,1937,668,1269,40,784,528,256,638,602,1,33,2,35
"2011","Southampton 029","E02003577","Total",4908,1211,409,802,160,1355,959,396,2115,2040,3,57,15,67
"2011","Southampton 030","E02003578","Total",2641,1905,758,1147,19,281,187,94,414,374,6,32,2,22
"2011","Southampton 031","E02003579","Total",3357,2118,886,1232,23,388,162,226,799,751,1,41,6,29
"2011","Southampton 032","E02003580","Total",2617,934,361,573,22,1452,1322,130,174,157,1,16,0,35
"2011","West Berkshire 001","E02003367","Total",2368,1547,730,817,16,384,21,363,332,277,39,9,7,89
"2011","West Berkshire 002","E02003368","Total",2416,1472,702,770,11,466,29,437,366,300,37,22,7,101
"2011","West Berkshire 003","E02003369","Total",2427,1853,950,903,6,176,12,164,320,272,27,14,7,72
"2011","West Berkshire 004","E02003370","Total",2642,2254,1066,1188,27,107,8,99,230,212,1,11,6,24
"2011","West Berkshire 005","E02003371","Total",2287,2149,1039,1110,6,13,3,10,107,87,2,17,1,12
"2011","West Berkshire 006","E02003372","Total",2949,2430,1127,1303,5,308,18,290,187,168,3,10,6,19
"2011","West Berkshire 007","E02003373","Total",2972,2073,942,1131,47,246,11,235,511,364,81,14,52,95
"2011","West Berkshire 008","E02003374","Total",2334,1736,596,1140,9,323,5,318,257,224,5,24,4,9
"2011","West Berkshire 009","E02003375","Total",2440,1475,586,889,44,481,24,457,382,352,3,20,7,58
"2011","West Berkshire 010","E02003376","Total",2600,1692,834,858,16,367,28,339,482,441,11,23,7,43
"2011","West Berkshire 011","E02003377","Total",3854,2817,1387,1430,63,364,22,342,503,393,69,23,18,107
"2011","West Berkshire 012","E02003378","Total",3466,2088,1086,1002,30,772,56,716,527,473,18,29,7,49
"2011","West Berkshire 013","E02003379","Total",2785,1678,634,1044,77,518,49,469,485,447,8,21,9,27
"2011","West Berkshire 014","E02003380","Total",3110,2455,914,1541,43,285,15,270,316,287,1,27,1,11
"2011","West Berkshire 015","E02003381","Total",2272,1635,679,956,11,256,9,247,345,203,100,7,35,25
"2011","West Berkshire 016","E02003382","Total",3129,1871,715,1156,32,826,66,760,377,340,5,27,5,23
"2011","West Berkshire 017","E02003383","Total",2708,2126,735,1391,25,231,27,204,307,286,3,15,3,19
"2011","West Berkshire 018","E02003384","Total",2587,1714,854,860,13,326,13,313,432,389,20,19,4,102
"2011","West Berkshire 019","E02003385","Total",3592,1763,706,1057,150,701,42,659,938,885,5,35,13,40
"2011","West Berkshire 020","E02003386","Total",3465,2062,873,1189,21,838,64,774,516,471,5,31,9,28
"2011","West Berkshire 021","E02003387","Total",3611,2938,1519,1419,17,285,26,259,344,319,7,17,1,27
"2011","West Berkshire 022","E02003388","Total",2326,1607,781,826,26,355,27,328,291,267,7,13,4,47
"2011","Windsor and Maidenhead 001","E02003421","Total",2148,1792,960,832,6,79,5,74,237,211,8,15,3,34
"2011","Windsor and Maidenhead 002","E02003422","Total",4718,3597,1985,1612,21,389,24,365,591,480,58,29,24,120
"2011","Windsor and Maidenhead 003","E02003423","Total",2289,1350,613,737,7,708,49,659,202,182,5,13,2,22
"2011","Windsor and Maidenhead 004","E02003424","Total",3430,2643,1361,1282,11,96,8,88,653,622,6,21,4,27
"2011","Windsor and Maidenhead 005","E02003425","Total",4704,2398,977,1421,103,1028,63,965,1084,1015,4,53,12,91
"2011","Windsor and Maidenhead 006","E02003426","Total",3721,2964,1399,1565,26,192,15,177,511,453,22,25,11,28
"2011","Windsor and Maidenhead 007","E02003427","Total",2833,1795,758,1037,17,573,33,540,418,389,2,21,6,30
"2011","Windsor and Maidenhead 008","E02003428","Total",3545,2608,1182,1426,23,649,63,586,229,211,3,15,0,36
"2011","Windsor and Maidenhead 009","E02003429","Total",2966,2389,1149,1240,7,194,5,189,328,290,13,19,6,48
"2011","Windsor and Maidenhead 010","E02003430","Total",2609,1277,590,687,15,366,44,322,681,544,92,19,26,270
"2011","Windsor and Maidenhead 011","E02003431","Total",2730,1850,780,1070,12,404,61,343,431,393,18,16,4,33
"2011","Windsor and Maidenhead 012","E02003432","Total",3021,1764,723,1041,12,415,43,372,809,736,25,28,20,21
"2011","Windsor and Maidenhead 013","E02003433","Total",2744,1880,1089,791,16,337,39,298,488,216,139,9,124,23
"2011","Windsor and Maidenhead 014","E02003434","Total",3688,2020,912,1108,42,1093,131,962,490,446,4,29,11,43
"2011","Windsor and Maidenhead 015","E02003435","Total",2844,1944,865,1079,9,163,23,140,696,575,60,12,49,32
"2011","Windsor and Maidenhead 016","E02003436","Total",3355,2549,1276,1273,4,237,14,223,494,329,89,21,55,71
"2011","Windsor and Maidenhead 017","E02003437","Total",2886,1941,896,1045,22,441,31,410,400,362,13,16,9,82
"2011","Windsor and Maidenhead 018","E02003438","Total",4118,2915,1498,1417,5,384,60,324,690,645,19,14,12,124
"2011","Wokingham 001","E02003439","Total",2272,1719,945,774,3,257,193,64,244,214,13,10,7,49
"2011","Wokingham 002","E02003440","Total",3634,2884,1341,1543,26,246,183,63,457,425,4,24,4,21
"2011","Wokingham 003","E02003441","Total",2954,2499,1255,1244,3,143,109,34,266,237,3,22,4,43
"2011","Wokingham 004","E02003442","Total",2760,2358,882,1476,21,38,12,26,330,316,0,13,1,13
"2011","Wokingham 005","E02003443","Total",2429,1611,823,788,18,575,460,115,192,176,2,11,3,33
"2011","Wokingham 006","E02003444","Total",3223,2649,1315,1334,24,156,49,107,365,340,3,17,5,29
"2011","Wokingham 007","E02003445","Total",3110,2816,1274,1542,6,32,7,25,248,223,2,22,1,8
"2011","Wokingham 008","E02003446","Total",3035,2685,1279,1406,7,64,28,36,261,235,11,11,4,18
"2011","Wokingham 009","E02003447","Total",3453,2472,884,1588,171,407,150,257,382,353,3,24,2,21
"2011","Wokingham 010","E02003448","Total",2617,2214,996,1218,4,92,68,24,274,247,11,14,2,33
"2011","Wokingham 011","E02003449","Total",3144,2488,726,1762,15,45,5,40,582,549,1,30,2,14
"2011","Wokingham 012","E02003450","Total",4206,3030,1155,1875,125,405,260,145,616,570,11,31,4,30
"2011","Wokingham 013","E02003451","Total",3725,2227,1113,1114,12,796,593,203,639,592,11,30,6,51
"2011","Wokingham 014","E02003452","Total",2428,2084,950,1134,36,87,71,16,201,184,2,14,1,20
"2011","Wokingham 015","E02003453","Total",2387,2211,983,1228,0,17,16,1,151,137,2,12,0,8
"2011","Wokingham 016","E02003454","Total",3045,2538,1158,1380,11,160,59,101,317,293,2,21,1,19
"2011","Wokingham 017","E02003455","Total",2669,1945,844,1101,145,203,175,28,329,298,4,19,8,47
"2011","Wokingham 018","E02003456","Total",2535,1663,685,978,40,343,265,78,446,202,150,12,82,43
"2011","Wokingham 019","E02003457","Total",3679,3335,1520,1815,7,108,86,22,211,191,5,12,3,18
"2011","Wokingham 020","E02003458","Total",3027,2675,1333,1342,5,62,56,6,244,219,8,14,3,41
"2011","Aylesbury Vale 001","E02003652","Total",3079,2386,1094,1292,25,225,50,175,400,367,7,21,5,43
"2011","Aylesbury Vale 002","E02003653","Total",2616,1758,828,930,14,385,112,273,433,401,5,22,5,26
"2011","Aylesbury Vale 003","E02003654","Total",2208,1791,856,935,18,190,65,125,168,145,4,17,2,41
"2011","Aylesbury Vale 004","E02003655","Total",3706,2790,1151,1639,32,376,96,280,435,382,14,29,10,73
"2011","Aylesbury Vale 005","E02003656","Total",2485,1829,927,902,8,285,68,217,319,291,5,19,4,44
"2011","Aylesbury Vale 006","E02003657","Total",2411,1811,889,922,18,271,82,189,264,230,11,18,5,47
"2011","Aylesbury Vale 007","E02003658","Total",2869,2225,1055,1170,25,305,69,236,261,226,4,23,8,53
"2011","Aylesbury Vale 008","E02003659","Total",3272,2202,935,1267,49,546,82,464,396,351,26,14,5,79
"2011","Aylesbury Vale 009","E02003660","Total",3823,3084,1346,1738,15,372,113,259,306,275,10,16,5,46
"2011","Aylesbury Vale 010","E02003661","Total",2066,1602,729,873,9,162,39,123,261,227,13,14,7,32
"2011","Aylesbury Vale 011","E02003662","Total",2592,1620,533,1087,17,415,111,304,518,485,3,25,5,22
"2011","Aylesbury Vale 012","E02003663","Total",2044,1195,342,853,5,613,215,398,210,189,5,13,3,21
"2011","Aylesbury Vale 013","E02003664","Total",2440,1605,646,959,16,473,116,357,309,281,1,23,4,37
"2011","Aylesbury Vale 014","E02003665","Total",2209,1658,663,995,17,166,37,129,362,336,1,22,3,6
"2011","Aylesbury Vale 015","E02003666","Total",2974,1434,641,793,123,520,82,438,865,809,6,40,10,32
"2011","Aylesbury Vale 016","E02003667","Total",3887,2694,624,2070,36,332,88,244,809,755,4,47,3,16
"2011","Aylesbury Vale 017","E02003668","Total",3472,3013,1577,1436,14,96,18,78,323,265,24,19,15,26
"2011","Aylesbury Vale 018","E02003669","Total",2506,1137,368,769,36,967,349,618,321,294,2,24,1,45
"2011","Aylesbury Vale 019","E02003670","Total",3650,2556,975,1581,44,442,54,388,587,512,14,37,24,21
"2011","Aylesbury Vale 020","E02003671","Total",2395,1513,432,1081,27,493,171,322,342,318,2,22,0,20
"2011","Aylesbury Vale 021","E02003672","Total",3837,3181,1525,1656,6,275,78,197,332,273,20,22,17,43
"2011","Aylesbury Vale 022","E02003673","Total",3387,2691,1462,1229,16,311,80,231,325,292,8,21,4,44
"2011","Aylesbury Vale 023","E02003674","Total",2137,1667,868,799,7,280,68,212,154,132,6,14,2,29
"2011","Aylesbury Vale 024","E02003675","Total",3341,2260,1141,1119,23,482,90,392,534,260,166,17,91,42
"2011","Chiltern 001","E02003676","Total",3190,2695,1605,1090,5,209,26,183,234,209,10,13,2,47
"2011","Chiltern 002","E02003677","Total",3751,2437,1206,1231,54,1001,176,825,235,218,0,13,4,24
"2011","Chiltern 003","E02003678","Total",2195,1792,835,957,8,152,28,124,223,205,1,16,1,20
"2011","Chiltern 004","E02003679","Total",2796,1673,767,906,20,644,85,559,431,403,4,18,6,28
"2011","Chiltern 005","E02003680","Total",4032,3266,1813,1453,9,392,49,343,316,282,18,12,4,49
"2011","Chiltern 006","E02003681","Total",3982,3011,1706,1305,8,492,72,420,441,408,9,17,7,30
"2011","Chiltern 007","E02003682","Total",3000,2227,1097,1130,37,308,35,273,395,373,5,15,2,33
"2011","Chiltern 008","E02003683","Total",2509,1831,1049,782,52,413,60,353,187,180,3,3,1,26
"2011","Chiltern 010","E02003685","Total",3185,2592,1424,1168,26,276,37,239,257,241,3,5,8,34
"2011","Chiltern 011","E02003686","Total",2702,2310,1250,1060,14,128,18,110,232,195,26,6,5,18
"2011","Chiltern 012","E02003687","Total",2182,1694,844,850,7,315,39,276,141,123,6,7,5,25
"2011","Chiltern 013","E02006823","Total",3422,2890,1595,1295,17,243,32,211,222,202,3,15,2,50
"2011","South Bucks 001","E02003688","Total",4733,3261,1842,1419,41,655,45,610,700,596,51,24,29,76
"2011","South Bucks 002","E02003689","Total",3160,2531,1396,1135,11,127,11,116,426,390,13,11,12,65
"2011","South Bucks 003","E02003690","Total",2806,1958,1040,918,44,459,39,420,315,273,10,25,7,30
"2011","South Bucks 004","E02003691","Total",2698,2015,1028,987,61,300,20,280,276,242,20,11,3,46
"2011","South Bucks 005","E02003692","Total",3354,2640,1433,1207,63,323,32,291,284,244,22,13,5,44
"2011","South Bucks 006","E02003693","Total",2520,2051,1133,918,21,105,12,93,295,255,18,11,11,48
"2011","South Bucks 007","E02003694","Total",3294,2126,948,1178,37,734,47,687,362,334,3,16,9,35
"2011","South Bucks 008","E02003695","Total",3949,2871,1279,1592,124,563,55,508,353,319,3,23,8,38
"2011","Wycombe 001","E02003696","Total",3500,2537,1422,1115,19,569,432,137,329,289,8,21,11,46
"2011","Wycombe 002","E02003697","Total",2384,1808,996,812,7,141,94,47,382,219,86,13,64,46
"2011","Wycombe 003","E02003698","Total",3247,2797,1514,1283,18,71,42,29,317,145,94,15,63,44
"2011","Wycombe 004","E02003699","Total",2290,1692,766,926,19,257,142,115,280,241,15,19,5,42
"2011","Wycombe 006","E02003701","Total",4149,2971,1223,1748,29,624,406,218,483,444,8,25,6,42
"2011","Wycombe 007","E02003702","Total",3207,2353,1213,1140,15,171,73,98,563,424,89,14,36,105
"2011","Wycombe 008","E02003703","Total",3049,1980,823,1157,25,229,112,117,777,729,7,26,15,38
"2011","Wycombe 009","E02003704","Total",2330,2021,906,1115,17,97,77,20,179,156,5,16,2,16
"2011","Wycombe 010","E02003705","Total",2491,1436,496,940,20,417,296,121,590,548,1,29,12,28
"2011","Wycombe 011","E02003706","Total",2657,1447,572,875,157,705,477,228,305,281,4,18,2,43
"2011","Wycombe 012","E02003707","Total",2445,1550,543,1007,30,341,220,121,500,462,4,30,4,24
"2011","Wycombe 013","E02003708","Total",3075,1535,517,1018,46,623,454,169,842,793,5,26,18,29
"2011","Wycombe 014","E02003709","Total",2315,1164,393,771,21,844,561,283,247,223,2,18,4,39
"2011","Wycombe 015","E02003710","Total",3520,2164,965,1199,47,313,135,178,936,789,68,33,46,60
"2011","Wycombe 016","E02003711","Total",3848,2103,698,1405,91,708,359,349,906,856,5,38,7,40
"2011","Wycombe 017","E02003712","Total",3246,2183,1010,1173,50,674,532,142,285,268,3,11,3,54
"2011","Wycombe 018","E02003713","Total",2390,2020,1033,987,1,188,176,12,154,135,7,11,1,27
"2011","Wycombe 019","E02003714","Total",2829,1980,839,1141,35,377,278,99,409,370,6,32,1,28
"2011","Wycombe 020","E02003715","Total",2563,2053,1129,924,6,117,54,63,359,171,127,3,58,28
"2011","Wycombe 021","E02003716","Total",2460,1832,974,858,4,239,180,59,341,316,2,21,2,44
"2011","Wycombe 022","E02003717","Total",3729,2788,1493,1295,7,421,368,53,461,428,8,21,4,52
"2011","Wycombe 023","E02003718","Total",2377,1625,723,902,10,297,250,47,415,388,3,21,3,30
"2011","Wycombe 024","E02006824","Total",3760,3240,1639,1601,13,227,74,153,256,225,10,19,2,24
"2011","Eastbourne 001","E02004356","Total",3009,1791,773,1018,60,756,550,206,370,342,2,26,0,32
"2011","Eastbourne 002","E02004357","Total",3050,1748,773,975,19,816,403,413,443,426,0,16,1,24
"2011","Eastbourne 003","E02004358","Total",3537,2393,1321,1072,19,750,564,186,330,298,1,27,4,45
"2011","Eastbourne 004","E02004359","Total",3484,2232,1260,972,11,789,514,275,415,380,2,31,2,37
"2011","Eastbourne 006","E02004361","Total",3330,2529,1389,1140,5,489,404,85,278,262,3,10,3,29
"2011","Eastbourne 007","E02004362","Total",3585,2457,1083,1374,21,315,110,205,757,699,4,49,5,35
"2011","Eastbourne 008","E02004363","Total",3280,1893,1039,854,11,236,34,202,1112,952,68,36,56,28
"2011","Eastbourne 009","E02004364","Total",3908,2620,1436,1184,17,452,202,250,783,716,2,58,7,36
"2011","Eastbourne 010","E02004365","Total",3590,1170,508,662,42,389,207,182,1952,1864,26,50,12,37
"2011","Eastbourne 011","E02004366","Total",3758,1781,1213,568,28,135,50,85,1730,1615,42,63,10,84
"2011","Eastbourne 012","E02004367","Total",3401,2602,1898,704,8,151,43,108,594,563,8,18,5,46
"2011","Eastbourne 013","E02006857","Total",3856,2684,1455,1229,19,449,256,193,668,601,1,53,13,36
"2011","Eastbourne 014","E02006858","Total",3224,1888,923,965,35,226,11,215,1062,1029,1,28,4,13
"2011","Hastings 001","E02004368","Total",3253,2494,1063,1431,19,295,48,247,414,354,12,38,10,31
"2011","Hastings 002","E02004369","Total",4206,3606,2194,1412,10,237,21,216,322,290,3,23,6,31
"2011","Hastings 003","E02004370","Total",3223,1310,494,816,12,1528,224,1304,340,313,1,21,5,33
"2011","Hastings 004","E02004371","Total",3007,1862,870,992,16,462,87,375,641,608,1,27,5,26
"2011","Hastings 005","E02004372","Total",2801,1101,475,626,9,1066,172,894,604,564,2,35,3,21
"2011","Hastings 006","E02004373","Total",3638,2366,1085,1281,34,514,49,465,676,614,4,49,9,48
"2011","Hastings 007","E02004374","Total",3530,2137,1067,1070,14,319,43,276,1006,947,4,44,11,54
"2011","Hastings 008","E02004375","Total",3973,2016,964,1052,9,286,21,265,1625,1544,11,59,11,37
"2011","Hastings 009","E02004376","Total",3793,1327,649,678,19,320,21,299,2086,2001,14,60,11,41
"2011","Hastings 010","E02004377","Total",4480,3042,1420,1622,30,308,26,282,1073,997,8,57,11,27
"2011","Hastings 011","E02004378","Total",5255,1445,790,655,21,653,51,602,3076,2959,12,86,19,60
"2011","Lewes 001","E02004379","Total",3008,2228,1121,1107,35,391,280,111,305,253,16,31,5,49
"2011","Lewes 002","E02004380","Total",3491,2748,1607,1141,12,245,202,43,400,346,17,29,8,86
"2011","Lewes 003","E02004381","Total",4363,2622,1356,1266,32,859,739,120,778,713,9,45,11,72
"2011","Lewes 004","E02004382","Total",2769,1784,1058,726,22,403,181,222,483,439,13,21,10,77
"2011","Lewes 005","E02004383","Total",3094,2255,1242,1013,10,432,345,87,373,338,4,29,2,24
"2011","Lewes 006","E02004384","Total",3161,2560,1225,1335,15,155,64,91,416,378,1,33,4,15
"2011","Lewes 007","E02004385","Total",3421,2588,1316,1272,20,201,115,86,576,518,1,53,4,36
"2011","Lewes 008","E02004386","Total",2784,2062,1104,958,15,174,116,58,507,465,7,30,5,26
"2011","Lewes 009","E02004387","Total",2468,1441,516,925,24,494,379,115,485,462,0,23,0,24
"2011","Lewes 010","E02004388","Total",2828,1971,1040,931,50,420,213,207,364,329,3,25,7,23
"2011","Lewes 011","E02004389","Total",4180,3617,2282,1335,27,137,76,61,366,334,1,28,3,33
"2011","Lewes 012","E02004390","Total",3473,2810,1768,1042,16,416,328,88,201,177,2,21,1,30
"2011","Lewes 013","E02004391","Total",3141,1962,1162,800,7,282,158,124,854,805,4,38,7,36
"2011","Rother 001","E02004392","Total",3639,2778,1380,1398,30,417,64,353,352,306,11,32,3,62
"2011","Rother 002","E02004393","Total",2763,2007,1250,757,13,395,52,343,285,241,20,18,6,63
"2011","Rother 003","E02004394","Total",3195,2468,1392,1076,8,316,54,262,333,290,14,22,7,70
"2011","Rother 004","E02004395","Total",3642,2421,1521,900,22,602,116,486,516,426,43,31,16,81
"2011","Rother 005","E02004396","Total",3815,3234,2119,1115,20,240,39,201,268,235,3,21,9,53
"2011","Rother 006","E02004397","Total",3362,2427,1388,1039,13,390,82,308,478,421,8,42,7,54
"2011","Rother 007","E02004398","Total",3679,1943,937,1006,35,1115,212,903,540,491,6,37,6,46
"2011","Rother 008","E02004399","Total",3572,2795,1790,1005,18,227,28,199,488,454,3,31,0,44
"2011","Rother 009","E02004400","Total",4697,4272,2962,1310,20,92,28,64,280,258,5,14,3,33
"2011","Rother 010","E02004401","Total",3801,3139,2192,947,17,217,17,200,379,335,0,41,3,49
"2011","Rother 011","E02004402","Total",4712,2576,1623,953,23,231,20,211,1823,1733,7,71,12,59
"2011","Wealden 001","E02004403","Total",2623,1895,994,901,7,216,163,53,412,377,15,18,2,93
"2011","Wealden 002","E02004404","Total",2570,2032,1061,971,15,154,96,58,290,258,8,19,5,79
"2011","Wealden 003","E02004405","Total",2342,1914,1030,884,60,140,45,95,205,188,1,14,2,23
"2011","Wealden 004","E02004406","Total",2988,2510,1405,1105,23,109,6,103,322,275,5,31,11,24
"2011","Wealden 005","E02004407","Total",3295,2546,1427,1119,7,273,166,107,379,340,9,27,3,90
"2011","Wealden 006","E02004408","Total",3126,2220,927,1293,44,452,335,117,374,337,2,31,4,36
"2011","Wealden 007","E02004409","Total",2189,1778,1002,776,6,93,75,18,245,210,13,13,9,67
"2011","Wealden 008","E02004410","Total",3153,2590,1382,1208,25,206,151,55,262,233,5,19,5,70
"2011","Wealden 009","E02004411","Total",3668,2728,1313,1415,29,431,306,125,432,403,2,25,2,48
"2011","Wealden 010","E02004412","Total",3330,2527,1269,1258,38,228,187,41,500,455,4,37,4,37
"2011","Wealden 011","E02004413","Total",2806,2267,1203,1064,25,184,116,68,286,261,6,14,5,44
"2011","Wealden 012","E02004414","Total",2409,1873,710,1163,18,186,76,110,302,281,1,15,5,30
"2011","Wealden 013","E02004415","Total",2398,1864,987,877,24,205,88,117,259,231,4,14,10,46
"2011","Wealden 014","E02004416","Total",2695,2165,1246,919,16,178,114,64,286,231,9,35,11,50
"2011","Wealden 015","E02004417","Total",2520,2025,1078,947,25,102,62,40,341,311,0,29,1,27
"2011","Wealden 016","E02004418","Total",2284,1668,837,831,29,371,93,278,193,167,4,20,2,23
"2011","Wealden 017","E02004419","Total",2473,1512,829,683,26,674,507,167,224,202,0,21,1,37
"2011","Wealden 018","E02004420","Total",4527,3810,2342,1468,30,146,81,65,454,393,17,40,4,87
"2011","Wealden 019","E02004421","Total",3649,2906,1710,1196,22,232,146,86,459,409,6,39,5,30
"2011","Wealden 020","E02004422","Total",4125,3412,1826,1586,24,149,89,60,484,435,5,40,4,56
"2011","Wealden 021","E02004423","Total",3506,3113,1905,1208,10,79,54,25,264,217,6,39,2,40
"2011","Basingstoke and Deane 001","E02004675","Total",3060,2327,1048,1279,26,447,17,430,233,204,5,22,2,27
"2011","Basingstoke and Deane 002","E02004676","Total",3361,2735,1281,1454,15,223,6,217,346,313,4,20,9,42
"2011","Basingstoke and Deane 003","E02004677","Total",2707,1928,981,947,24,368,25,343,291,254,23,10,4,96
"2011","Basingstoke and Deane 004","E02004678","Total",3127,2325,1162,1163,18,377,33,344,317,280,16,15,6,90
"2011","Basingstoke and Deane 005","E02004679","Total",3430,2480,1039,1441,30,482,16,466,370,333,14,16,7,68
"2011","Basingstoke and Deane 006","E02004680","Total",2849,2155,626,1529,42,160,5,155,482,463,1,18,0,10
"2011","Basingstoke and Deane 007","E02004681","Total",4551,2364,663,1701,182,1462,84,1378,504,446,7,45,6,39
"2011","Basingstoke and Deane 008","E02004682","Total",3238,2242,771,1471,31,504,27,477,448,432,3,13,0,13
"2011","Basingstoke and Deane 009","E02004683","Total",2802,1478,605,873,58,883,35,848,347,317,3,24,3,36
"2011","Basingstoke and Deane 010","E02004684","Total",3645,2355,779,1576,74,875,45,830,319,288,0,30,1,22
"2011","Basingstoke and Deane 011","E02004685","Total",3292,1620,684,936,153,671,15,656,818,780,4,24,10,30
"2011","Basingstoke and Deane 012","E02004686","Total",3544,2027,816,1211,69,596,17,579,814,760,9,44,1,38
"2011","Basingstoke and Deane 013","E02004687","Total",2761,1541,530,1011,44,941,38,903,211,190,1,16,4,24
"2011","Basingstoke and Deane 014","E02004688","Total",3472,1726,778,948,13,1441,67,1374,252,223,0,27,2,40
"2011","Basingstoke and Deane 015","E02004689","Total",2277,1854,1032,822,1,197,3,194,192,173,10,6,3,33
"2011","Basingstoke and Deane 016","E02004690","Total",3179,2503,964,1539,31,300,11,289,324,302,1,21,0,21
"2011","Basingstoke and Deane 017","E02004691","Total",3232,2376,1309,1067,43,311,8,303,389,348,20,14,7,113
"2011","Basingstoke and Deane 018","E02004692","Total",2996,2775,1519,1256,2,120,4,116,90,80,1,8,1,9
"2011","Basingstoke and Deane 019","E02004693","Total",3041,1722,499,1223,22,930,29,901,345,315,1,26,3,22
"2011","Basingstoke and Deane 020","E02004694","Total",2872,1976,951,1025,23,450,29,421,361,317,15,27,2,62
"2011","Basingstoke and Deane 021","E02004695","Total",3235,2571,521,2050,24,219,5,214,414,396,4,14,0,7
"2011","Basingstoke and Deane 022","E02004696","Total",2644,1856,959,897,33,389,21,368,305,259,23,20,3,61
"2011","East Hampshire 001","E02004697","Total",2223,1729,899,830,10,122,16,106,307,252,28,17,10,55
"2011","East Hampshire 002","E02004698","Total",2503,1080,517,563,21,1016,170,846,343,313,5,18,7,43
"2011","East Hampshire 003","E02004699","Total",4442,3531,1793,1738,51,289,33,256,531,434,29,48,20,40
"2011","East Hampshire 004","E02004700","Total",2170,1085,319,766,49,543,84,459,465,233,125,15,92,28
"2011","East Hampshire 006","E02004702","Total",3241,2391,882,1509,35,477,65,412,312,282,4,22,4,26
"2011","East Hampshire 007","E02004703","Total",4175,3393,1787,1606,51,287,27,260,346,295,19,27,5,98
"2011","East Hampshire 008","E02004704","Total",2325,1714,807,907,31,254,39,215,284,214,39,16,15,42
"2011","East Hampshire 009","E02004705","Total",3532,2647,1335,1312,36,420,53,367,380,342,9,23,6,49
"2011","East Hampshire 010","E02004706","Total",3030,2282,1244,1038,12,344,40,304,348,318,6,16,8,44
"2011","East Hampshire 011","E02004707","Total",4529,3333,1799,1534,44,417,49,368,609,505,55,33,16,126
"2011","East Hampshire 012","E02004708","Total",3918,2373,1321,1052,49,755,74,681,696,648,7,39,2,45
"2011","East Hampshire 013","E02004709","Total",3020,2577,1230,1347,7,184,22,162,222,202,2,18,0,30
"2011","East Hampshire 014","E02004710","Total",2569,2040,950,1090,4,310,37,273,187,167,0,15,5,28
"2011","East Hampshire 016","E02006829","Total",2772,2366,1282,1084,22,115,20,95,244,217,1,26,0,25
"2011","East Hampshire 017","E02006838","Total",2809,2378,1355,1023,9,148,13,135,243,214,8,16,5,31
"2011","Eastleigh 001","E02004712","Total",3487,3122,1778,1344,17,34,0,34,297,276,1,20,0,17
"2011","Eastleigh 002","E02004713","Total",3212,2723,1307,1416,7,165,16,149,292,266,1,23,2,25
"2011","Eastleigh 003","E02004714","Total",3371,2758,1406,1352,31,160,13,147,393,353,4,33,3,29
"2011","Eastleigh 004","E02004715","Total",3429,2325,949,1376,46,571,43,528,457,420,0,32,5,30
"2011","Eastleigh 005","E02004716","Total",3563,2616,1170,1446,37,585,44,541,299,268,1,27,3,26
"2011","Eastleigh 006","E02004717","Total",3996,2007,761,1246,91,1362,152,1210,496,447,2,41,6,40
"2011","Eastleigh 007","E02004718","Total",3796,2023,712,1311,63,757,72,685,905,837,5,57,6,48
"2011","Eastleigh 008","E02004719","Total",3977,3473,1566,1907,13,132,11,121,333,299,2,31,1,26
"2011","Eastleigh 009","E02004720","Total",4748,3702,1730,1972,55,361,25,336,596,543,4,45,4,34
"2011","Eastleigh 010","E02004721","Total",3569,2673,777,1896,96,270,17,253,512,471,2,38,1,18
"2011","Eastleigh 011","E02004722","Total",3098,2218,1083,1135,25,538,57,481,296,264,5,27,0,21
"2011","Eastleigh 012","E02004723","Total",3816,3386,1596,1790,13,54,6,48,347,314,3,28,2,16
"2011","Eastleigh 013","E02004724","Total",3200,2113,929,1184,30,643,36,607,381,344,4,29,4,33
"2011","Eastleigh 014","E02004725","Total",2398,1488,664,824,8,505,50,455,373,336,5,26,6,24
"2011","Eastleigh 015","E02004726","Total",2517,1735,800,935,20,274,31,243,461,426,3,22,10,27
"2011","Fareham 001","E02004727","Total",3384,2851,986,1865,25,163,41,122,325,273,21,27,4,20
"2011","Fareham 002","E02004728","Total",3472,2585,1034,1551,51,369,139,230,436,368,20,31,17,31
"2011","Fareham 003","E02004729","Total",3062,2151,951,1200,21,637,468,169,221,195,3,23,0,32
"2011","Fareham 004","E02004730","Total",3544,3139,1717,1422,10,136,14,122,224,196,2,18,8,35
"2011","Fareham 005","E02004731","Total",3232,2733,1217,1516,8,93,37,56,380,345,2,30,3,18
"2011","Fareham 006","E02004732","Total",3279,2735,1337,1398,8,173,129,44,338,296,6,32,4,25
"2011","Fareham 007","E02004733","Total",3111,2355,1110,1245,61,297,192,105,367,299,28,25,15,31
"2011","Fareham 008","E02004734","Total",4370,3384,1589,1795,19,292,103,189,624,569,9,39,7,51
"2011","Fareham 009","E02004735","Total",3206,2873,1615,1258,11,29,11,18,277,168,55,19,35,16
"2011","Fareham 010","E02004736","Total",3398,3057,1631,1426,7,112,90,22,204,177,1,23,3,18
"2011","Fareham 011","E02004737","Total",3278,1968,818,1150,27,764,588,176,470,425,8,35,2,49
"2011","Fareham 012","E02004738","Total",3212,2560,1315,1245,6,369,312,57,247,211,0,32,4,30
"2011","Fareham 013","E02004739","Total",2913,2404,1390,1014,19,266,223,43,195,172,4,17,2,29
"2011","Fareham 014","E02004740","Total",3118,2665,1569,1096,4,85,23,62,337,212,69,17,39,27
"2011","Gosport 001","E02004741","Total",3161,2195,999,1196,32,705,499,206,196,170,3,22,1,33
"2011","Gosport 002","E02004742","Total",3231,2056,909,1147,7,829,658,171,303,223,29,29,22,36
"2011","Gosport 003","E02004743","Total",3162,2526,1067,1459,10,190,139,51,405,315,33,44,13,31
"2011","Gosport 004","E02004744","Total",3251,1331,434,897,36,910,220,690,953,499,248,44,162,21
"2011","Gosport 005","E02004745","Total",3900,2267,737,1530,91,758,464,294,746,688,6,45,7,38
"2011","Gosport 006","E02004746","Total",4616,3555,1804,1751,67,337,110,227,620,435,113,37,35,37
"2011","Gosport 007","E02004747","Total",2914,1989,847,1142,37,323,230,93,541,409,47,46,39,24
"2011","Gosport 008","E02004748","Total",4767,1936,845,1091,80,1466,884,582,1203,1118,6,61,18,82
"2011","Gosport 009","E02004749","Total",3058,2644,1562,1082,4,67,8,59,325,225,65,22,13,18
"2011","Gosport 010","E02004750","Total",3370,2616,1209,1407,17,230,85,145,485,424,18,32,11,22
"2011","Hart 001","E02004751","Total",3293,2618,1229,1389,9,386,22,364,251,205,20,17,9,29
"2011","Hart 002","E02004752","Total",3162,2834,1161,1673,10,81,3,78,224,205,2,16,1,13
"2011","Hart 003","E02004753","Total",3851,3209,1408,1801,31,209,21,188,374,319,12,34,9,28
"2011","Hart 004","E02004754","Total",2549,1815,965,850,5,357,36,321,317,280,21,10,6,55
"2011","Hart 005","E02004755","Total",4728,3304,1178,2126,202,221,11,210,950,906,8,34,2,51
"2011","Hart 006","E02004756","Total",3214,2475,1002,1473,71,305,26,279,343,306,5,24,8,20
"2011","Hart 007","E02004757","Total",3160,2882,1532,1350,7,83,7,76,171,153,4,12,2,17
"2011","Hart 008","E02004758","Total",3100,2381,1200,1181,22,395,32,363,273,250,7,12,4,29
"2011","Hart 009","E02004759","Total",3239,2814,1305,1509,9,122,10,112,278,254,5,16,3,16
"2011","Hart 010","E02004760","Total",2941,2106,892,1214,31,246,19,227,535,287,156,13,79,23
"2011","Hart 011","E02004761","Total",2273,1309,738,571,9,313,28,285,570,215,206,14,135,72
"2011","Havant 003","E02004764","Total",3421,2849,1562,1287,16,362,89,273,161,146,1,14,0,33
"2011","Havant 004","E02004765","Total",2640,2193,1017,1176,4,20,5,15,407,380,1,25,1,16
"2011","Havant 005","E02004766","Total",2632,1530,715,815,6,864,109,755,200,178,2,15,5,32
"2011","Havant 006","E02004767","Total",2247,1078,411,667,21,940,739,201,173,136,0,36,1,35
"2011","Havant 007","E02004768","Total",2274,1409,544,865,13,561,60,501,275,250,2,23,0,16
"2011","Havant 008","E02004769","Total",2478,980,380,600,30,1234,1011,223,207,181,1,24,1,27
"2011","Havant 009","E02004770","Total",2880,1391,541,850,14,1224,863,361,213,179,0,28,6,38
"2011","Havant 010","E02004771","Total",3621,1749,710,1039,35,1429,996,433,353,314,0,33,6,55
"2011","Havant 011","E02004772","Total",3852,3067,1384,1683,22,442,387,55,290,259,1,28,2,31
"2011","Havant 013","E02004774","Total",4329,3279,2115,1164,16,434,43,391,542,459,30,25,28,58
"2011","Havant 014","E02004775","Total",3969,2984,1670,1314,19,435,45,390,498,461,8,22,7,33
"2011","Havant 015","E02004776","Total",2546,2159,1286,873,6,171,25,146,180,150,8,15,7,30
"2011","Havant 016","E02004777","Total",2608,1784,1101,683,10,307,27,280,484,437,1,41,5,23
"2011","Havant 017","E02004778","Total",2805,2224,1345,879,8,132,29,103,414,376,6,30,2,27
"2011","Havant 018","E02006822","Total",3602,2873,1462,1411,9,383,154,229,308,261,3,44,0,29
"2011","Havant 019","E02006830","Total",2771,1536,680,856,44,963,701,262,209,190,1,17,1,19
"2011","Havant 020","E02006831","Total",2636,2302,1246,1056,8,136,17,119,173,153,3,16,1,17
"2011","New Forest 001","E02004779","Total",4691,3405,2082,1323,21,485,315,170,670,590,27,38,15,110
"2011","New Forest 002","E02004780","Total",2550,1779,847,932,11,502,427,75,229,206,1,19,3,29
"2011","New Forest 003","E02004781","Total",3332,2632,995,1637,22,236,44,192,413,371,4,38,0,29
"2011","New Forest 004","E02004782","Total",3322,2356,1181,1175,32,488,287,201,401,361,5,28,7,45
"2011","New Forest 005","E02004783","Total",2924,2342,981,1361,11,222,138,84,324,290,0,32,2,25
"2011","New Forest 006","E02004784","Total",2289,2007,1215,792,4,81,39,42,178,159,6,9,4,19
"2011","New Forest 007","E02004785","Total",2422,1812,1146,666,10,223,150,73,323,274,16,20,13,54
"2011","New Forest 008","E02004786","Total",3608,2532,1036,1496,27,398,148,250,629,464,87,44,34,22
"2011","New Forest 009","E02004787","Total",3480,2814,1658,1156,16,205,99,106,418,375,6,30,7,27
"2011","New Forest 010","E02004788","Total",2887,2437,1360,1077,19,128,65,63,276,238,10,20,8,27
"2011","New Forest 011","E02004789","Total",4406,3088,1689,1399,49,872,545,327,362,279,40,24,19,35
"2011","New Forest 012","E02004790","Total",3445,2159,1180,979,31,530,365,165,690,629,3,53,5,35
"2011","New Forest 013","E02004791","Total",2201,1364,650,714,9,654,288,366,157,128,0,25,4,17
"2011","New Forest 014","E02004792","Total",3723,2973,1689,1284,23,303,117,186,387,331,12,27,17,37
"2011","New Forest 015","E02004793","Total",3081,2525,1691,834,11,215,140,75,286,251,18,15,2,44
"2011","New Forest 016","E02004794","Total",2825,2231,1300,931,7,194,132,62,324,278,20,13,13,69
"2011","New Forest 017","E02004795","Total",4028,2661,1886,775,28,350,256,94,846,745,47,35,19,143
"2011","New Forest 018","E02004796","Total",4259,3733,2366,1367,16,165,61,104,308,274,4,28,2,37
"2011","New Forest 019","E02004797","Total",3540,2164,1166,998,46,822,690,132,460,427,1,29,3,48
"2011","New Forest 020","E02004798","Total",2668,1512,801,711,27,819,610,209,275,250,4,21,0,35
"2011","New Forest 021","E02004799","Total",3881,2781,1893,888,39,382,178,204,632,593,2,28,9,47
"2011","New Forest 022","E02004800","Total",3561,3164,2311,853,10,66,6,60,291,260,11,18,2,30
"2011","New Forest 023","E02004801","Total",3716,3132,2307,825,15,100,85,15,414,380,6,23,5,55
"2011","Rushmoor 001","E02004802","Total",2547,1587,608,979,18,717,105,612,198,157,6,29,6,27
"2011","Rushmoor 002","E02004803","Total",2648,1259,326,933,36,1067,134,933,262,207,1,46,8,24
"2011","Rushmoor 003","E02004804","Total",2780,2397,879,1518,15,106,15,91,250,212,3,25,10,12
"2011","Rushmoor 004","E02004805","Total",3334,2661,1177,1484,110,176,11,165,364,324,14,18,8,23
"2011","Rushmoor 005","E02004806","Total",3177,2427,823,1604,99,288,30,258,338,250,33,24,31,25
"2011","Rushmoor 006","E02004807","Total",3785,2642,1105,1537,57,555,75,480,499,436,18,30,15,32
"2011","Rushmoor 007","E02004808","Total",4180,2285,790,1495,68,622,53,569,1169,762,218,30,159,36
"2011","Rushmoor 008","E02004809","Total",2856,573,168,405,158,477,44,433,1626,744,468,22,392,22
"2011","Rushmoor 009","E02004810","Total",2945,1862,523,1339,32,559,85,474,471,414,8,36,13,21
"2011","Rushmoor 010","E02004811","Total",3210,2065,852,1213,31,408,57,351,679,630,5,32,12,27
"2011","Rushmoor 011","E02004812","Total",2395,1984,735,1249,16,51,3,48,334,307,2,19,6,10
"2011","Rushmoor 012","E02004813","Total",2487,1347,448,899,7,901,159,742,189,164,1,21,3,43
"2011","Test Valley 001","E02004814","Total",2861,2175,896,1279,12,266,58,208,339,303,13,20,3,69
"2011","Test Valley 002","E02004815","Total",2837,1286,331,955,17,1269,510,759,238,200,6,30,2,27
"2011","Test Valley 003","E02004816","Total",3968,2098,925,1173,55,1200,303,897,559,470,45,32,12,56
"2011","Test Valley 004","E02004817","Total",3259,2015,861,1154,34,687,245,442,484,437,5,37,5,39
"2011","Test Valley 005","E02004818","Total",4092,2917,1377,1540,29,466,126,340,630,423,120,27,60,50
"2011","Test Valley 006","E02004819","Total",3291,2471,1127,1344,20,234,67,167,533,494,3,30,6,33
"2011","Test Valley 007","E02004820","Total",2856,1833,942,891,29,346,120,226,604,249,222,12,121,44
"2011","Test Valley 008","E02004821","Total",2161,1486,818,668,4,196,56,140,336,265,33,19,19,139
"2011","Test Valley 009","E02004822","Total",3255,2170,1271,899,25,454,110,344,462,385,41,24,12,144
"2011","Test Valley 010","E02004823","Total",3814,3136,1686,1450,27,276,84,192,345,313,5,26,1,30
"2011","Test Valley 011","E02004824","Total",2864,1798,1184,614,5,579,186,393,418,371,12,28,7,64
"2011","Test Valley 012","E02004825","Total",4416,3532,1879,1653,31,427,126,301,385,340,12,31,2,41
"2011","Test Valley 013","E02004826","Total",2620,2018,1172,846,17,226,75,151,299,249,28,17,5,60
"2011","Test Valley 014","E02004827","Total",2831,2461,853,1608,2,99,0,99,259,245,2,9,3,10
"2011","Test Valley 015","E02004828","Total",2501,2105,1090,1015,4,129,49,80,237,220,3,10,4,26
"2011","Winchester 001","E02004829","Total",2236,1508,724,784,40,198,99,99,435,223,129,13,70,55
"2011","Winchester 002","E02004830","Total",2608,1874,943,931,21,377,310,67,267,228,8,22,9,69
"2011","Winchester 003","E02004831","Total",3417,2714,1614,1100,9,292,176,116,342,243,57,12,30,60
"2011","Winchester 004","E02004832","Total",3591,2545,1501,1044,40,418,332,86,470,418,17,28,7,118
"2011","Winchester 005","E02004833","Total",3428,2289,1189,1100,43,648,397,251,411,373,6,23,9,37
"2011","Winchester 006","E02004834","Total",3167,1194,540,654,24,1434,1168,266,452,415,5,23,9,63
"2011","Winchester 007","E02004835","Total",4418,2284,1256,1028,70,778,290,488,1160,1025,76,39,20,126
"2011","Winchester 008","E02004836","Total",2177,686,349,337,9,1030,771,259,423,382,9,23,9,29
"2011","Winchester 009","E02004837","Total",3092,2405,1296,1109,11,216,169,47,422,388,11,22,1,38
"2011","Winchester 010","E02004838","Total",3685,2870,1514,1356,40,352,271,81,354,312,13,23,6,69
"2011","Winchester 011","E02004839","Total",3314,2613,1473,1140,10,303,199,104,306,259,12,24,11,82
"2011","Winchester 012","E02004840","Total",3986,3086,1535,1551,15,440,298,142,386,339,6,33,8,59
"2011","Winchester 013","E02004841","Total",4517,3118,1271,1847,74,480,310,170,751,697,8,42,4,94
"2011","Winchester 014","E02004842","Total",3229,2460,1180,1280,20,277,180,97,425,315,45,21,44,47
"2011","Ashford 001","E02004996","Total",3331,2207,1138,1069,28,470,348,122,547,497,24,20,6,79
"2011","Ashford 002","E02004997","Total",3161,2381,1306,1075,19,447,350,97,257,224,3,26,4,57
"2011","Ashford 003","E02004998","Total",2669,2103,1034,1069,33,192,108,84,305,278,2,22,3,36
"2011","Ashford 004","E02004999","Total",5136,3386,1417,1969,75,796,465,331,829,740,18,55,16,50
"2011","Ashford 005","E02005000","Total",3922,2049,805,1244,26,881,549,332,906,811,10,70,15,60
"2011","Ashford 006","E02005001","Total",3575,2714,1261,1453,23,350,243,107,446,380,25,31,10,42
"2011","Ashford 007","E02005002","Total",3795,2174,811,1363,31,881,749,132,664,624,0,35,5,45
"2011","Ashford 008","E02005003","Total",3069,1707,510,1197,81,869,413,456,374,336,1,33,4,38
"2011","Ashford 009","E02005004","Total",4473,2868,798,2070,119,505,324,181,934,868,6,42,18,47
"2011","Ashford 010","E02005005","Total",2952,2392,1211,1181,31,189,137,52,295,259,7,23,6,45
"2011","Ashford 011","E02005006","Total",2193,1703,960,743,22,250,187,63,179,147,3,25,4,39
"2011","Ashford 012","E02005007","Total",3494,2590,1275,1315,98,256,204,52,489,451,6,29,3,61
"2011","Ashford 013","E02005008","Total",3686,2667,1699,968,38,507,357,150,412,377,4,29,2,62
"2011","Ashford 014","E02005009","Total",2331,1744,975,769,14,322,268,54,212,181,6,20,5,39
"2011","Canterbury 001","E02005010","Total",3522,1828,920,908,12,279,142,137,1350,1294,5,45,6,53
"2011","Canterbury 002","E02005011","Total",3152,2668,1602,1066,66,168,94,74,211,183,3,24,1,39
"2011","Canterbury 003","E02005012","Total",3603,2592,1300,1292,16,535,397,138,418,372,2,38,6,42
"2011","Canterbury 004","E02005013","Total",3558,2677,1487,1190,21,410,384,26,413,351,5,53,4,37
"2011","Canterbury 005","E02005014","Total",3688,3326,1961,1365,15,16,9,7,297,257,1,38,1,34
"2011","Canterbury 006","E02005015","Total",3352,2760,1245,1515,47,97,31,66,415,364,3,42,6,33
"2011","Canterbury 007","E02005016","Total",3317,2389,1290,1099,17,512,347,165,370,323,1,41,5,29
"2011","Canterbury 008","E02005017","Total",3303,2240,1134,1106,11,114,90,24,883,821,3,50,9,55
"2011","Canterbury 009","E02005018","Total",3393,2836,1606,1230,25,250,188,62,248,207,5,31,5,34
"2011","Canterbury 010","E02005019","Total",2380,1678,825,853,16,279,198,81,361,316,13,26,6,46
"2011","Canterbury 011","E02005020","Total",2865,2065,1080,985,25,412,357,55,319,269,11,30,9,44
"2011","Canterbury 012","E02005021","Total",2635,2100,1227,873,5,108,69,39,362,322,7,20,13,60
"2011","Canterbury 013","E02005022","Total",2959,1173,724,449,28,782,302,480,955,911,6,33,5,21
"2011","Canterbury 014","E02005023","Total",3158,739,377,362,59,1302,992,310,1000,753,94,32,121,58
"2011","Canterbury 016","E02005025","Total",3495,1992,1165,827,26,377,234,143,1037,933,30,49,25,63
"2011","Canterbury 017","E02005026","Total",3046,2273,1079,1194,8,305,208,97,426,385,13,26,2,34
"2011","Canterbury 018","E02005027","Total",2203,1728,963,765,6,147,113,34,270,237,14,14,5,52
"2011","Canterbury 019","E02006855","Total",2356,1006,432,574,28,587,458,129,696,647,6,35,8,39
"2011","Canterbury 020","E02006856","Total",4786,2037,1161,876,69,729,426,303,1845,1720,30,70,25,106
"2011","Dartford 001","E02005028","Total",3156,1317,451,866,94,1409,1138,271,286,263,1,22,0,50
"2011","Dartford 002","E02005029","Total",4021,2341,628,1713,113,377,173,204,1162,1114,6,38,4,28
"2011","Dartford 003","E02005030","Total",4093,2693,1004,1689,110,335,116,219,924,873,4,42,5,31
"2011","Dartford 004","E02005031","Total",3258,1600,528,1072,84,896,688,208,640,610,9,17,4,38
"2011","Dartford 005","E02005032","Total",3931,2628,914,1714,20,198,143,55,1054,976,5,53,20,31
"2011","Dartford 006","E02005033","Total",2897,1546,534,1012,35,641,562,79,636,612,1,20,3,39
"2011","Dartford 007","E02005034","Total",2843,2586,1196,1390,1,14,9,5,226,204,2,18,2,16
"2011","Dartford 008","E02005035","Total",3038,2444,1094,1350,23,163,101,62,378,348,1,26,3,30
"2011","Dartford 009","E02005036","Total",2556,1330,472,858,7,884,613,271,298,268,4,23,3,37
"2011","Dartford 010","E02005037","Total",2742,2390,1235,1155,17,130,50,80,185,178,1,5,1,20
"2011","Dartford 011","E02005038","Total",2333,1961,954,1007,5,195,149,46,156,146,0,7,3,16
"2011","Dartford 012","E02005039","Total",2692,1831,755,1076,20,584,485,99,232,213,5,13,1,25
"2011","Dartford 013","E02005040","Total",2521,2152,1247,905,8,121,111,10,208,198,2,7,1,32
"2011","Dover 001","E02005041","Total",2851,2034,1105,929,24,360,216,144,380,328,31,15,6,53
"2011","Dover 002","E02005042","Total",3999,2766,1595,1171,10,557,419,138,562,509,6,43,4,104
"2011","Dover 003","E02005043","Total",3353,2457,1353,1104,48,305,215,90,494,442,7,39,6,49
"2011","Dover 004","E02005044","Total",3446,2291,1359,932,19,97,37,60,986,928,6,44,8,53
"2011","Dover 005","E02005045","Total",3298,2309,1107,1202,12,466,341,125,445,383,10,48,4,66
"2011","Dover 006","E02005046","Total",2619,1616,756,860,8,660,495,165,252,215,3,31,3,83
"2011","Dover 007","E02005047","Total",3354,2241,1179,1062,5,686,399,287,361,324,1,27,9,61
"2011","Dover 008","E02005048","Total",2678,2221,1234,987,11,152,138,14,262,220,8,31,3,32
"2011","Dover 009","E02005049","Total",3200,2625,1753,872,16,174,114,60,337,296,5,31,5,48
"2011","Dover 010","E02005050","Total",3719,3128,1620,1508,25,236,47,189,298,230,16,29,23,32
"2011","Dover 011","E02005051","Total",5514,2615,1018,1597,27,1729,1097,632,1072,997,3,61,11,71
"2011","Dover 012","E02005052","Total",3590,1614,877,737,12,629,306,323,1252,1064,55,55,78,83
"2011","Dover 013","E02005053","Total",3813,1777,731,1046,19,684,381,303,1292,1223,5,55,9,41
"2011","Dover 014","E02005054","Total",2876,2448,1347,1101,9,129,72,57,261,235,4,17,5,29
"2011","Gravesham 001","E02005055","Total",3167,1428,536,892,42,868,714,154,794,761,2,24,7,35
"2011","Gravesham 002","E02005056","Total",4550,1610,774,836,61,917,650,267,1885,1816,6,48,15,77
"2011","Gravesham 003","E02005057","Total",4146,2435,1098,1337,63,621,423,198,978,924,3,42,9,49
"2011","Gravesham 004","E02005058","Total",2974,1723,684,1039,20,551,416,135,639,606,4,23,6,41
"2011","Gravesham 005","E02005059","Total",3819,2915,1382,1533,20,202,61,141,646,600,4,39,3,36
"2011","Gravesham 006","E02005060","Total",2879,1911,934,977,34,663,529,134,236,217,0,15,4,35
"2011","Gravesham 007","E02005061","Total",2777,1546,696,850,17,961,924,37,193,170,2,15,6,60
"2011","Gravesham 008","E02005062","Total",2606,2152,1008,1144,5,254,235,19,177,163,0,13,1,18
"2011","Gravesham 009","E02005063","Total",2469,1782,859,923,16,484,388,96,171,153,3,13,2,16
"2011","Gravesham 010","E02005064","Total",2702,2213,1225,988,6,251,209,42,200,167,7,16,10,32
"2011","Gravesham 011","E02005065","Total",2904,1585,649,936,5,1006,905,101,261,235,5,18,3,47
"2011","Gravesham 012","E02005066","Total",3146,2781,1583,1198,6,134,116,18,195,168,5,20,2,30
"2011","Gravesham 013","E02005067","Total",2292,2018,980,1038,10,96,58,38,149,128,3,16,2,19
"2011","Maidstone 001","E02005068","Total",2706,2283,857,1426,29,72,20,52,301,269,4,22,6,21
"2011","Maidstone 002","E02005069","Total",3465,2721,1307,1414,35,133,7,126,554,509,3,38,4,22
"2011","Maidstone 003","E02005070","Total",3650,3312,1884,1428,23,19,4,15,270,235,6,26,3,26
"2011","Maidstone 004","E02005071","Total",4423,1899,686,1213,93,891,142,749,1492,1263,74,60,95,48
"2011","Maidstone 005","E02005072","Total",3055,2646,1241,1405,9,70,2,68,313,285,1,22,5,17
"2011","Maidstone 006","E02005073","Total",4713,2400,874,1526,120,575,71,504,1585,1490,7,74,14,33
"2011","Maidstone 007","E02005074","Total",3336,2829,1430,1399,15,72,8,64,383,348,2,29,4,37
"2011","Maidstone 008","E02005075","Total",3700,2318,868,1450,64,580,97,483,700,611,35,41,13,38
"2011","Maidstone 009","E02005076","Total",3434,2087,693,1394,21,549,103,446,749,707,1,36,5,28
"2011","Maidstone 010","E02005077","Total",3021,1965,848,1117,39,779,170,609,206,172,6,25,3,32
"2011","Maidstone 011","E02005078","Total",3230,2500,1273,1227,26,265,40,225,388,350,9,20,9,51
"2011","Maidstone 012","E02005079","Total",3241,2787,1473,1314,18,147,19,128,260,233,4,21,2,29
"2011","Maidstone 013","E02005080","Total",4530,1890,862,1028,30,2299,536,1763,231,202,1,15,13,80
"2011","Maidstone 014","E02005081","Total",2861,2202,1262,940,8,279,47,232,328,300,7,15,6,44
"2011","Maidstone 015","E02005082","Total",3820,2856,1264,1592,67,488,65,423,362,314,14,27,7,47
"2011","Maidstone 016","E02005083","Total",2808,2308,1170,1138,28,257,50,207,181,161,2,15,3,34
"2011","Maidstone 017","E02005084","Total",2579,1951,1083,868,11,218,44,174,327,267,31,25,4,72
"2011","Maidstone 018","E02005085","Total",2564,1905,909,996,18,254,50,204,326,279,18,24,5,61
"2011","Maidstone 019","E02005086","Total",2311,1841,901,940,17,119,20,99,300,269,7,21,3,34
"2011","Sevenoaks 001","E02005087","Total",2804,2349,1194,1155,37,214,45,169,177,154,8,13,2,27
"2011","Sevenoaks 002","E02005088","Total",3916,1973,849,1124,96,1551,272,1279,233,217,0,14,2,63
"2011","Sevenoaks 003","E02005089","Total",2533,2037,1018,1019,28,207,33,174,235,208,5,18,4,26
"2011","Sevenoaks 004","E02005090","Total",2405,2008,1199,809,29,213,27,186,115,96,2,12,5,40
"2011","Sevenoaks 005","E02005091","Total",2896,2215,1099,1116,78,302,33,269,257,225,9,16,7,44
"2011","Sevenoaks 007","E02005093","Total",2505,2132,1182,950,37,151,25,126,160,134,9,13,4,25
"2011","Sevenoaks 008","E02005094","Total",3514,2488,1249,1239,71,334,33,301,568,511,16,32,9,53
"2011","Sevenoaks 009","E02005095","Total",2950,2416,1360,1056,55,283,34,249,163,140,4,18,1,33
"2011","Sevenoaks 010","E02005096","Total",4009,2473,1184,1289,142,758,64,694,589,541,13,28,7,47
"2011","Sevenoaks 011","E02005097","Total",3362,2851,1580,1271,22,145,10,135,286,260,14,8,4,58
"2011","Sevenoaks 012","E02005098","Total",3914,2591,1488,1103,10,452,18,434,752,677,48,9,18,109
"2011","Sevenoaks 013","E02005099","Total",3265,2298,1194,1104,27,415,44,371,448,397,21,17,13,77
"2011","Sevenoaks 014","E02005100","Total",3785,2568,1240,1328,119,660,117,543,388,362,4,17,5,50
"2011","Sevenoaks 015","E02005101","Total",2694,1830,1006,824,24,355,35,320,403,371,11,14,7,82
"2011","Sevenoaks 016","E02006832","Total",2468,1971,800,1171,23,178,10,168,283,254,3,24,2,13
"2011","Shepway 001","E02005102","Total",2695,2223,1340,883,13,125,104,21,278,244,8,17,9,56
"2011","Shepway 002","E02005103","Total",3602,2540,983,1557,38,450,212,238,543,436,33,49,25,31
"2011","Shepway 003","E02005104","Total",3388,2017,966,1051,7,952,688,264,372,345,3,22,2,40
"2011","Shepway 004","E02005105","Total",3254,1656,630,1026,7,526,275,251,1035,973,2,54,6,30
"2011","Shepway 005","E02005106","Total",3608,2162,916,1246,30,685,449,236,686,507,43,45,91,45
"2011","Shepway 006","E02005107","Total",5068,3720,2076,1644,14,172,41,131,1122,1023,14,69,16,40
"2011","Shepway 008","E02005109","Total",2893,2480,1588,892,16,49,36,13,315,284,4,24,3,33
"2011","Shepway 009","E02005110","Total",2853,2480,1403,1077,5,113,64,49,214,163,15,25,11,41
"2011","Shepway 010","E02005111","Total",3648,2265,1457,808,16,632,491,141,665,606,13,40,6,70
"2011","Shepway 011","E02005112","Total",3047,2287,1402,885,7,362,297,65,330,265,10,44,11,61
"2011","Shepway 012","E02005113","Total",2984,2309,1361,948,13,269,143,126,348,294,3,43,8,45
"2011","Shepway 013","E02005114","Total",2814,2048,1138,910,7,253,208,45,465,412,15,26,12,41
"2011","Shepway 014","E02006879","Total",3842,966,546,420,24,553,265,288,2262,2184,13,40,25,37
"2011","Shepway 015","E02006880","Total",3683,1562,938,624,17,170,11,159,1885,1821,8,51,5,49
"2011","Swale 001","E02005115","Total",2441,1147,485,662,20,149,25,124,1104,1064,7,28,5,21
"2011","Swale 002","E02005116","Total",2567,1034,472,562,15,1040,173,867,445,413,1,26,5,33
"2011","Swale 003","E02005117","Total",2492,1968,1120,848,13,271,33,238,215,184,1,25,5,25
"2011","Swale 004","E02005118","Total",3696,2638,1080,1558,78,382,57,325,565,517,5,38,5,33
"2011","Swale 005","E02005119","Total",2438,1671,902,769,3,323,55,268,415,375,7,31,2,26
"2011","Swale 006","E02005120","Total",2729,2025,1067,958,12,178,20,158,458,423,5,20,10,56
"2011","Swale 007","E02005121","Total",4706,3356,866,2490,50,619,117,502,654,602,1,46,5,27
"2011","Swale 008","E02005122","Total",2795,2228,1116,1112,17,271,22,249,253,218,2,27,6,26
"2011","Swale 009","E02005123","Total",4328,3194,1258,1936,84,394,65,329,622,575,7,31,9,34
"2011","Swale 010","E02005124","Total",3692,1776,805,971,38,984,167,817,842,789,4,38,11,52
"2011","Swale 011","E02005125","Total",3120,2070,860,1210,26,584,99,485,401,361,4,34,2,39
"2011","Swale 012","E02005126","Total",3184,2542,1323,1219,11,245,45,200,355,324,2,27,2,31
"2011","Swale 013","E02005127","Total",3406,2736,1313,1423,90,255,41,214,291,259,3,24,5,34
"2011","Swale 014","E02005128","Total",3449,2502,1212,1290,34,535,65,470,344,311,4,24,5,34
"2011","Swale 015","E02005129","Total",4896,3109,1495,1614,49,894,116,778,766,698,8,51,9,78
"2011","Swale 016","E02005130","Total",3358,2258,1155,1103,23,535,80,455,475,420,21,27,7,67
"2011","Swale 017","E02005131","Total",2288,1697,915,782,6,283,36,247,241,202,14,18,7,61
"2011","Thanet 001","E02005132","Total",4393,1247,642,605,25,523,113,410,2558,2482,6,55,15,40
"2011","Thanet 002","E02005133","Total",3739,3046,1867,1179,10,98,8,90,536,487,3,41,5,49
"2011","Thanet 003","E02005134","Total",3079,1258,464,794,7,416,144,272,1368,1300,9,56,3,30
"2011","Thanet 004","E02005135","Total",3222,1864,795,1069,13,470,121,349,836,675,81,59,21,39
"2011","Thanet 005","E02005136","Total",3176,2400,1171,1229,6,369,111,258,365,329,1,32,3,36
"2011","Thanet 006","E02005137","Total",3205,1532,686,846,8,1327,787,540,303,276,0,27,0,35
"2011","Thanet 007","E02005138","Total",3985,2369,1294,1075,11,532,196,336,1022,964,5,49,4,51
"2011","Thanet 008","E02005139","Total",4214,3468,2353,1115,12,120,41,79,559,505,6,44,4,55
"2011","Thanet 009","E02005140","Total",3429,2763,1697,1066,7,147,32,115,481,434,1,41,5,31
"2011","Thanet 010","E02005141","Total",3133,2178,1294,884,26,87,18,69,793,730,5,50,8,49
"2011","Thanet 011","E02005142","Total",3108,2377,1379,998,5,353,128,225,326,289,2,29,6,47
"2011","Thanet 012","E02005143","Total",3450,2287,1146,1141,12,413,111,302,700,640,1,55,4,38
"2011","Thanet 013","E02005144","Total",3440,1674,746,928,7,1296,717,579,425,376,0,41,8,38
"2011","Thanet 014","E02005145","Total",2948,2152,1154,998,13,304,83,221,421,344,26,31,20,58
"2011","Thanet 015","E02005146","Total",3130,1841,742,1099,10,198,60,138,1041,958,8,66,9,40
"2011","Thanet 016","E02005147","Total",4455,1686,890,796,21,732,327,405,1972,1881,11,65,15,44
"2011","Thanet 017","E02005148","Total",3407,2765,1583,1182,13,152,22,130,445,402,2,36,5,32
"2011","Tonbridge and Malling 001","E02005149","Total",4167,3396,1370,2026,47,310,33,277,382,344,3,29,6,32
"2011","Tonbridge and Malling 002","E02005150","Total",4288,2740,1053,1687,104,931,121,810,485,439,3,38,5,28
"2011","Tonbridge and Malling 003","E02005151","Total",4932,3722,1488,2234,92,724,106,618,352,313,3,30,6,42
"2011","Tonbridge and Malling 005","E02005153","Total",3460,2356,1115,1241,49,772,65,707,254,208,19,11,16,29
"2011","Tonbridge and Malling 006","E02005154","Total",4333,3306,1701,1605,24,512,63,449,421,377,12,23,9,70
"2011","Tonbridge and Malling 007","E02005155","Total",3920,2987,952,2035,108,355,57,298,437,409,9,15,4,33
"2011","Tonbridge and Malling 008","E02005156","Total",2915,2025,1070,955,26,526,49,477,285,234,19,22,10,53
"2011","Tonbridge and Malling 009","E02005157","Total",2677,1677,925,752,34,853,90,763,91,73,3,15,0,22
"2011","Tonbridge and Malling 010","E02005158","Total",2550,2114,1110,1004,9,214,34,180,178,148,17,10,3,35
"2011","Tonbridge and Malling 011","E02005159","Total",3145,2304,1341,963,24,674,77,597,110,99,3,7,1,33
"2011","Tonbridge and Malling 012","E02005160","Total",4210,2477,1163,1314,116,688,95,593,863,756,57,39,11,66
"2011","Tonbridge and Malling 013","E02005161","Total",3332,2177,892,1285,61,470,52,418,589,541,2,41,5,35
"2011","Tonbridge and Malling 014","E02006833","Total",4211,2965,1497,1468,23,733,88,645,422,379,17,19,7,68
"2011","Tunbridge Wells 001","E02005162","Total",4198,3039,1483,1556,25,631,59,572,456,407,14,28,7,47
"2011","Tunbridge Wells 002","E02005163","Total",3097,2278,993,1285,18,373,19,354,390,349,5,31,5,38
"2011","Tunbridge Wells 003","E02005164","Total",3318,2134,932,1202,35,721,49,672,393,363,0,23,7,35
"2011","Tunbridge Wells 004","E02005165","Total",3077,2298,1166,1132,12,464,33,431,267,246,6,11,4,36
"2011","Tunbridge Wells 005","E02005166","Total",2839,1262,536,726,41,1242,135,1107,271,247,2,16,6,23
"2011","Tunbridge Wells 006","E02005167","Total",2957,2389,1263,1126,7,214,11,203,298,256,21,16,5,49
"2011","Tunbridge Wells 007","E02005168","Total",3097,2267,1073,1194,52,64,3,61,690,656,3,27,4,24
"2011","Tunbridge Wells 008","E02005169","Total",4630,1919,753,1166,56,509,47,462,2101,2016,18,57,10,45
"2011","Tunbridge Wells 009","E02005170","Total",4028,2824,1391,1433,36,389,15,374,744,697,6,37,4,35
"2011","Tunbridge Wells 010","E02005171","Total",2642,1361,623,738,12,910,96,814,326,302,5,18,1,33
"2011","Tunbridge Wells 011","E02005172","Total",3213,2280,1169,1111,10,379,26,353,469,412,26,22,9,75
"2011","Tunbridge Wells 012","E02005173","Total",3734,2654,1427,1227,14,242,13,229,789,760,0,25,4,35
"2011","Tunbridge Wells 013","E02005174","Total",2961,1956,1088,868,39,549,33,516,326,291,13,21,1,91
"2011","Tunbridge Wells 014","E02005175","Total",3383,2338,1214,1124,19,461,27,434,475,410,23,35,7,90
"2011","Cherwell 001","E02005921","Total",2248,1770,966,804,15,139,33,106,277,253,6,14,4,47
"2011","Cherwell 002","E02005922","Total",3404,2263,695,1568,39,410,83,327,666,630,2,33,1,26
"2011","Cherwell 003","E02005923","Total",2301,1296,493,803,19,573,135,438,381,352,3,20,6,32
"2011","Cherwell 004","E02005924","Total",4852,2126,752,1374,90,826,119,707,1756,1683,10,53,10,54
"2011","Cherwell 005","E02005925","Total",3139,1576,573,1003,4,1259,373,886,252,214,1,31,6,48
"2011","Cherwell 006","E02005926","Total",3210,2470,1400,1070,12,202,42,160,474,440,8,20,6,52
"2011","Cherwell 007","E02005927","Total",2219,1613,766,847,15,176,12,164,401,377,2,19,3,14
"2011","Cherwell 008","E02005928","Total",2975,2436,1285,1151,31,165,15,150,300,258,11,23,8,43
"2011","Cherwell 009","E02005929","Total",2814,2199,1181,1018,14,251,52,199,284,230,19,24,11,66
"2011","Cherwell 010","E02005930","Total",3123,2183,1168,1015,19,244,37,207,621,584,4,14,19,56
"2011","Cherwell 011","E02005931","Total",3325,2305,918,1387,15,219,30,189,616,349,137,28,102,170
"2011","Cherwell 012","E02005932","Total",2683,1941,454,1487,8,208,18,190,509,478,3,27,1,17
"2011","Cherwell 013","E02005933","Total",2950,2126,790,1336,22,410,110,300,365,335,3,25,2,27
"2011","Cherwell 014","E02005934","Total",3531,2648,1101,1547,21,535,135,400,289,269,1,14,5,38
"2011","Cherwell 015","E02005935","Total",3122,2051,631,1420,17,304,15,289,711,676,3,29,3,39
"2011","Cherwell 016","E02005936","Total",3335,2524,1299,1225,43,317,59,258,374,331,13,25,5,77
"2011","Cherwell 017","E02005937","Total",2768,2056,1147,909,16,301,140,161,349,316,1,26,6,46
"2011","Cherwell 018","E02005938","Total",2149,1665,856,809,17,215,30,185,231,214,3,14,0,21
"2011","Cherwell 019","E02005939","Total",2580,2055,1037,1018,26,118,15,103,350,315,3,30,2,31
"2011","Oxford 001","E02005940","Total",2593,1730,1003,727,9,332,258,74,486,459,5,18,4,36
"2011","Oxford 002","E02005941","Total",2835,1573,970,603,18,380,264,116,788,688,52,28,20,76
"2011","Oxford 003","E02005942","Total",2458,1456,900,556,57,99,15,84,744,669,18,27,30,102
"2011","Oxford 004","E02005943","Total",2516,1668,981,687,18,245,233,12,550,513,6,29,2,35
"2011","Oxford 005","E02005944","Total",2813,1021,472,549,74,1157,936,221,508,472,3,27,6,53
"2011","Oxford 006","E02005945","Total",3772,1988,1156,832,27,519,183,336,1175,1101,20,33,21,63
"2011","Oxford 007","E02005946","Total",3306,2096,1033,1063,27,344,263,81,788,739,7,29,13,51
"2011","Oxford 008","E02005947","Total",2705,657,410,247,65,496,177,319,1309,1118,86,29,76,178
"2011","Oxford 009","E02005948","Total",2856,1048,574,474,8,423,258,165,1303,1180,24,23,76,74
"2011","Oxford 010","E02005949","Total",2527,765,404,361,21,1051,766,285,651,589,23,27,12,39
"2011","Oxford 011","E02005950","Total",4080,1315,698,617,32,662,238,424,2004,1892,12,49,51,67
"2011","Oxford 012","E02005951","Total",2592,1196,637,559,33,462,385,77,858,827,2,23,6,43
"2011","Oxford 013","E02005952","Total",5317,2450,1044,1406,139,945,482,463,1709,1608,8,77,16,74
"2011","Oxford 014","E02005953","Total",2187,1073,493,580,27,368,320,48,687,653,1,23,10,32
"2011","Oxford 015","E02005954","Total",3800,2274,1134,1140,33,598,435,163,842,785,8,34,15,53
"2011","Oxford 016","E02005955","Total",3936,1909,827,1082,91,1188,924,264,693,663,2,22,6,55
"2011","Oxford 017","E02005956","Total",2390,886,348,538,51,1167,843,324,261,243,0,14,4,25
"2011","Oxford 018","E02005957","Total",2692,768,193,575,229,1392,533,859,278,259,0,12,7,25
"2011","South Oxfordshire 001","E02005958","Total",2301,1750,703,1047,9,175,23,152,348,318,7,19,4,19
"2011","South Oxfordshire 002","E02005959","Total",2214,1699,1008,691,17,208,38,170,242,203,10,9,20,48
"2011","South Oxfordshire 003","E02005960","Total",2422,1848,999,849,22,299,36,263,223,202,4,14,3,30
"2011","South Oxfordshire 004","E02005961","Total",2745,2043,1130,913,15,293,41,252,353,315,14,17,7,41
"2011","South Oxfordshire 005","E02005962","Total",3285,2796,1416,1380,27,206,26,180,221,201,1,15,4,35
"2011","South Oxfordshire 006","E02005963","Total",3226,2316,1233,1083,20,483,100,383,351,308,13,20,10,56
"2011","South Oxfordshire 007","E02005964","Total",2934,2356,1289,1067,22,233,27,206,275,240,8,22,5,48
"2011","South Oxfordshire 008","E02005965","Total",2252,1530,831,699,16,252,35,217,395,360,17,14,4,59
"2011","South Oxfordshire 009","E02005966","Total",3173,2301,509,1792,51,127,10,117,683,652,2,25,4,11
"2011","South Oxfordshire 010","E02005967","Total",2265,1610,817,793,30,363,53,310,246,163,44,21,18,16
"2011","South Oxfordshire 011","E02005968","Total",2559,1495,815,680,10,202,25,177,810,300,312,17,181,42
"2011","South Oxfordshire 012","E02005969","Total",3901,2630,1331,1299,77,709,95,614,453,405,8,28,12,32
"2011","South Oxfordshire 013","E02005970","Total",2384,1413,460,953,31,452,81,371,472,442,7,21,2,16
"2011","South Oxfordshire 014","E02005971","Total",2311,1705,832,873,12,399,64,335,163,142,3,17,1,32
"2011","South Oxfordshire 015","E02005972","Total",3210,2404,1271,1133,24,409,47,362,323,280,20,19,4,50
"2011","South Oxfordshire 016","E02005973","Total",2616,1721,1063,658,14,350,47,303,486,455,4,22,5,45
"2011","South Oxfordshire 017","E02005974","Total",2641,1771,952,819,22,338,33,305,482,453,4,16,9,28
"2011","South Oxfordshire 018","E02005975","Total",3082,2437,1413,1024,17,268,27,241,273,225,25,18,5,87
"2011","South Oxfordshire 019","E02005976","Total",2278,1765,1015,750,9,163,21,142,250,205,28,7,10,91
"2011","South Oxfordshire 020","E02005977","Total",2305,1871,1026,845,14,234,25,209,162,130,10,13,9,24
"2011","Vale of White Horse 001","E02005978","Total",2739,2217,1263,954,3,192,40,152,287,255,6,21,5,40
"2011","Vale of White Horse 002","E02005979","Total",3728,2866,1599,1267,22,277,62,215,522,467,17,27,11,41
"2011","Vale of White Horse 003","E02005980","Total",4005,2736,1602,1134,37,454,82,372,609,277,200,19,113,169
"2011","Vale of White Horse 004","E02005981","Total",3544,3045,1308,1737,17,116,12,104,354,326,2,25,1,12
"2011","Vale of White Horse 005","E02005982","Total",2450,1877,888,989,12,194,103,91,347,303,11,16,17,20
"2011","Vale of White Horse 006","E02005983","Total",4845,2655,1199,1456,75,1091,194,897,944,885,11,36,12,80
"2011","Vale of White Horse 007","E02005984","Total",2812,2220,1171,1049,17,181,23,158,329,290,17,13,9,65
"2011","Vale of White Horse 008","E02005985","Total",3201,2009,1031,978,39,797,176,621,324,304,7,10,3,32
"2011","Vale of White Horse 009","E02005986","Total",3822,2463,1136,1327,68,697,128,569,529,472,23,18,16,65
"2011","Vale of White Horse 010","E02005987","Total",3156,2244,1156,1088,11,525,110,415,342,309,5,18,10,34
"2011","Vale of White Horse 011","E02005988","Total",2918,2264,1048,1216,23,318,44,274,292,203,43,29,17,21
"2011","Vale of White Horse 014","E02005991","Total",4074,2804,1419,1385,133,603,83,520,486,423,16,27,20,48
"2011","Vale of White Horse 015","E02005992","Total",3748,2639,1443,1196,39,534,92,442,477,436,20,13,8,59
"2011","Vale of White Horse 016","E02006886","Total",4365,2711,1441,1270,18,604,81,523,891,473,247,32,139,141
"2011","West Oxfordshire 001","E02005993","Total",2815,1875,978,897,36,486,90,396,382,342,10,24,6,36
"2011","West Oxfordshire 002","E02005994","Total",2445,1705,920,785,14,252,46,206,357,311,25,18,3,117
"2011","West Oxfordshire 003","E02005995","Total",2511,1824,1020,804,14,255,45,210,322,288,15,15,4,96
"2011","West Oxfordshire 004","E02005996","Total",3469,2453,1373,1080,25,372,43,329,546,477,30,27,12,73
"2011","West Oxfordshire 005","E02005997","Total",2419,1854,1040,814,15,283,39,244,233,208,5,17,3,34
"2011","West Oxfordshire 006","E02005998","Total",2357,1900,1046,854,4,144,22,122,284,243,14,17,10,25
"2011","West Oxfordshire 007","E02005999","Total",2510,2021,1069,952,24,213,40,173,207,179,5,16,7,45
"2011","West Oxfordshire 008","E02006000","Total",4790,3477,1419,2058,111,569,76,493,595,538,12,39,6,38
"2011","West Oxfordshire 009","E02006001","Total",2251,1442,441,1001,28,503,20,483,265,242,2,20,1,13
"2011","West Oxfordshire 010","E02006002","Total",4380,2781,1422,1359,124,758,77,681,665,605,12,39,9,52
"2011","West Oxfordshire 011","E02006003","Total",2236,1626,905,721,8,320,72,248,258,230,4,19,5,24
"2011","West Oxfordshire 012","E02006004","Total",2446,1660,930,730,21,291,41,250,371,330,22,14,5,103
"2011","West Oxfordshire 013","E02006005","Total",3564,2009,590,1419,85,313,31,282,1139,563,339,30,207,18
"2011","West Oxfordshire 014","E02006006","Total",2321,1452,684,768,22,306,39,267,521,310,121,23,67,20
"2011","West Oxfordshire 015","E02006007","Total",2727,2062,1078,984,17,322,57,265,278,242,12,18,6,48
"2011","Elmbridge 001","E02006317","Total",2509,1977,938,1039,19,207,57,150,288,266,6,15,1,18
"2011","Elmbridge 002","E02006318","Total",2685,2087,1018,1069,5,66,11,55,498,469,3,21,5,29
"2011","Elmbridge 003","E02006319","Total",2824,1921,775,1146,25,530,135,395,315,283,3,25,4,33
"2011","Elmbridge 004","E02006320","Total",2787,1703,573,1130,45,649,157,492,370,340,3,17,10,20
"2011","Elmbridge 005","E02006321","Total",2451,1951,827,1124,11,131,22,109,333,310,3,17,3,25
"2011","Elmbridge 006","E02006322","Total",2504,1923,829,1094,10,281,43,238,270,253,3,14,0,20
"2011","Elmbridge 007","E02006323","Total",3063,2047,1016,1031,63,207,38,169,716,688,4,19,5,30
"2011","Elmbridge 008","E02006324","Total",2773,2129,867,1262,35,327,98,229,254,233,2,18,1,28
"2011","Elmbridge 009","E02006325","Total",3226,2780,1286,1494,11,96,19,77,305,288,4,11,2,34
"2011","Elmbridge 010","E02006326","Total",2722,1953,900,1053,16,214,24,190,516,495,4,14,3,23
"2011","Elmbridge 011","E02006327","Total",2662,2045,1035,1010,3,122,23,99,458,433,4,20,1,34
"2011","Elmbridge 012","E02006328","Total",4002,2554,1163,1391,30,400,94,306,964,915,14,29,6,54
"2011","Elmbridge 013","E02006329","Total",2638,1895,1017,878,18,266,42,224,416,375,24,12,5,43
"2011","Elmbridge 014","E02006330","Total",3844,2597,1215,1382,33,717,117,600,446,400,15,22,9,51
"2011","Elmbridge 015","E02006331","Total",2788,2234,1144,1090,11,261,48,213,257,250,0,6,1,25
"2011","Elmbridge 016","E02006332","Total",2567,1854,836,1018,6,74,20,54,579,550,2,25,2,54
"2011","Elmbridge 017","E02006333","Total",3765,2461,1288,1173,11,527,149,378,687,615,34,30,8,79
"2011","Elmbridge 018","E02006334","Total",3112,2549,1392,1157,41,143,27,116,334,315,1,13,5,45
"2011","Epsom and Ewell 001","E02006335","Total",3187,2609,1331,1278,7,177,13,164,368,347,1,18,2,26
"2011","Epsom and Ewell 002","E02006336","Total",2670,1941,777,1164,38,486,41,445,198,177,1,16,4,7
"2011","Epsom and Ewell 003","E02006337","Total",3303,2995,1504,1491,4,52,3,49,237,212,2,21,2,15
"2011","Epsom and Ewell 004","E02006338","Total",2638,2237,1093,1144,38,110,13,97,243,211,2,24,6,10
"2011","Epsom and Ewell 005","E02006339","Total",3379,2308,757,1551,99,487,32,455,455,413,3,34,5,30
"2011","Epsom and Ewell 007","E02006341","Total",3846,2653,1264,1389,23,442,20,422,701,663,7,29,2,27
"2011","Epsom and Ewell 008","E02006342","Total",3392,2010,1050,960,30,301,17,284,993,926,24,39,4,58
"2011","Epsom and Ewell 009","E02006343","Total",3239,2699,1349,1350,15,157,6,151,323,272,33,15,3,45
"2011","Epsom and Ewell 010","E02006837","Total",4130,3479,1844,1635,3,178,21,157,444,407,18,13,6,26
"2011","Guildford 001","E02006344","Total",3291,2496,1342,1154,22,363,255,108,336,248,66,15,7,74
"2011","Guildford 002","E02006345","Total",2411,1616,909,707,20,219,152,67,532,154,197,7,174,24
"2011","Guildford 003","E02006346","Total",3862,3320,1911,1409,24,193,136,57,282,251,12,11,8,43
"2011","Guildford 004","E02006347","Total",3079,2411,1022,1389,20,169,95,74,455,413,3,26,13,24
"2011","Guildford 005","E02006348","Total",3456,2686,1401,1285,49,371,204,167,314,257,15,23,19,36
"2011","Guildford 006","E02006349","Total",3106,2080,770,1310,123,333,176,157,548,512,2,21,13,22
"2011","Guildford 007","E02006350","Total",2400,1198,426,772,40,849,742,107,274,244,4,21,5,39
"2011","Guildford 008","E02006351","Total",3404,2342,1001,1341,30,448,322,126,540,513,4,20,3,44
"2011","Guildford 009","E02006352","Total",2274,1557,665,892,47,288,279,9,357,337,2,12,6,25
"2011","Guildford 010","E02006353","Total",2612,1729,752,977,18,651,320,331,196,178,0,15,3,18
"2011","Guildford 011","E02006354","Total",3599,2965,1608,1357,28,81,45,36,495,462,10,22,1,30
"2011","Guildford 012","E02006355","Total",2368,940,438,502,16,976,898,78,406,364,10,19,13,30
"2011","Guildford 013","E02006356","Total",4977,2346,1057,1289,98,576,214,362,1895,1792,24,58,21,62
"2011","Guildford 014","E02006357","Total",2636,2145,936,1209,22,268,221,47,181,160,3,15,3,20
"2011","Guildford 015","E02006358","Total",2472,1465,698,767,61,337,284,53,578,511,6,25,36,31
"2011","Guildford 016","E02006359","Total",2559,1871,1085,786,1,191,125,66,461,428,10,17,6,35
"2011","Guildford 017","E02006360","Total",3220,2338,1235,1103,65,389,338,51,352,311,20,12,9,76
"2011","Guildford 018","E02006361","Total",2247,1643,948,695,18,206,122,84,320,291,11,12,6,60
"2011","Mole Valley 001","E02006362","Total",2677,2187,1252,935,10,245,32,213,196,173,7,14,2,39
"2011","Mole Valley 002","E02006363","Total",2340,1952,1012,940,8,171,26,145,197,180,4,11,2,12
"2011","Mole Valley 003","E02006364","Total",3177,1603,604,999,92,798,113,685,637,583,14,34,6,47
"2011","Mole Valley 004","E02006365","Total",2535,1962,1130,832,19,155,11,144,366,326,20,17,3,33
"2011","Mole Valley 005","E02006366","Total",3112,2769,1489,1280,4,124,14,110,194,176,6,12,0,21
"2011","Mole Valley 006","E02006367","Total",2444,1899,1150,749,5,339,40,299,182,156,3,18,5,19
"2011","Mole Valley 007","E02006368","Total",2396,1908,1096,812,1,259,34,225,204,178,9,12,5,24
"2011","Mole Valley 008","E02006369","Total",2866,2236,1408,828,21,215,26,189,344,276,35,7,26,50
"2011","Mole Valley 009","E02006370","Total",2646,1960,973,987,12,221,26,195,403,362,10,23,8,50
"2011","Mole Valley 010","E02006371","Total",3025,2000,1027,973,33,420,43,377,535,489,10,34,2,37
"2011","Mole Valley 011","E02006372","Total",2703,1628,729,899,64,720,83,637,273,247,6,13,7,18
"2011","Mole Valley 012","E02006373","Total",3039,2089,1075,1014,28,364,28,336,474,427,7,29,11,84
"2011","Mole Valley 013","E02006374","Total",2868,2169,1066,1103,34,342,55,287,265,222,12,20,11,58
"2011","Reigate and Banstead 001","E02006375","Total",2381,2073,988,1085,5,145,18,127,147,132,4,10,1,11
"2011","Reigate and Banstead 002","E02006376","Total",3349,2726,1431,1295,39,255,43,212,295,268,6,21,0,34
"2011","Reigate and Banstead 003","E02006377","Total",2287,2023,1064,959,11,119,24,95,129,112,1,9,7,5
"2011","Reigate and Banstead 004","E02006378","Total",3325,2733,1140,1593,58,239,39,200,265,239,4,17,5,30
"2011","Reigate and Banstead 005","E02006379","Total",2519,1453,569,884,86,812,166,646,154,138,0,13,3,14
"2011","Reigate and Banstead 006","E02006380","Total",2798,2431,1258,1173,2,100,16,84,227,202,5,15,5,38
"2011","Reigate and Banstead 007","E02006381","Total",2767,2337,1182,1155,8,147,28,119,239,224,4,7,4,36
"2011","Reigate and Banstead 008","E02006382","Total",2574,1593,608,985,17,731,213,518,211,187,6,14,4,22
"2011","Reigate and Banstead 009","E02006383","Total",3836,2954,1484,1470,13,111,14,97,687,645,8,28,6,71
"2011","Reigate and Banstead 010","E02006384","Total",4197,2556,1209,1347,66,792,177,615,754,706,8,34,6,29
"2011","Reigate and Banstead 011","E02006385","Total",4284,2614,866,1748,177,309,47,262,1157,1106,7,37,7,27
"2011","Reigate and Banstead 012","E02006386","Total",3164,2305,1036,1269,5,346,25,321,471,440,5,19,7,37
"2011","Reigate and Banstead 013","E02006387","Total",2585,1738,784,954,30,592,124,468,207,180,1,22,4,18
"2011","Reigate and Banstead 014","E02006388","Total",3553,2515,941,1574,41,449,89,360,528,493,3,27,5,20
"2011","Reigate and Banstead 015","E02006389","Total",2747,2005,961,1044,11,463,142,321,241,218,8,13,2,27
"2011","Reigate and Banstead 016","E02006390","Total",3134,2322,1067,1255,12,528,107,421,254,230,3,20,1,18
"2011","Reigate and Banstead 017","E02006391","Total",2336,1834,753,1081,32,66,3,63,385,362,1,20,2,19
"2011","Reigate and Banstead 018","E02006392","Total",3587,2274,1052,1222,60,401,70,331,818,771,7,31,9,34
"2011","Runnymede 001","E02006393","Total",2709,1531,729,802,27,323,201,122,789,752,8,22,7,39
"2011","Runnymede 002","E02006394","Total",3333,1705,848,857,11,664,391,273,889,817,28,22,22,64
"2011","Runnymede 003","E02006395","Total",3800,2553,975,1578,42,682,587,95,483,441,8,28,6,40
"2011","Runnymede 004","E02006396","Total",2426,1901,1048,853,21,197,135,62,264,233,12,13,6,43
"2011","Runnymede 005","E02006397","Total",2323,1743,982,761,31,78,65,13,398,359,24,7,8,73
"2011","Runnymede 006","E02006398","Total",3348,2057,854,1203,62,665,474,191,513,478,6,18,11,51
"2011","Runnymede 007","E02006399","Total",4574,3424,1637,1787,59,495,321,174,549,486,11,33,19,47
"2011","Runnymede 008","E02006400","Total",2374,1700,870,830,18,314,45,269,309,230,46,5,28,33
"2011","Runnymede 009","E02006401","Total",3958,2893,1304,1589,34,509,426,83,480,439,11,24,6,42
"2011","Runnymede 010","E02006402","Total",3869,3224,1580,1644,21,283,252,31,300,257,19,23,1,41
"2011","Spelthorne 001","E02006403","Total",2622,1468,585,883,90,684,85,599,358,335,3,18,2,22
"2011","Spelthorne 002","E02006404","Total",2476,1451,573,878,88,635,87,548,277,257,3,16,1,25
"2011","Spelthorne 003","E02006405","Total",3995,3267,1490,1777,29,142,21,121,524,496,7,19,2,33
"2011","Spelthorne 004","E02006406","Total",3528,2041,847,1194,41,418,34,384,985,927,12,35,11,43
"2011","Spelthorne 005","E02006407","Total",3584,2802,1364,1438,20,321,51,270,403,377,3,20,3,38
"2011","Spelthorne 006","E02006408","Total",3486,2612,1147,1465,58,285,39,246,510,470,5,33,2,21
"2011","Spelthorne 007","E02006409","Total",2712,1768,746,1022,31,682,89,593,195,184,0,10,1,36
"2011","Spelthorne 008","E02006410","Total",3163,1955,758,1197,40,734,92,642,391,365,7,17,2,43
"2011","Spelthorne 009","E02006411","Total",3033,2553,1344,1209,25,111,9,102,326,295,3,25,3,18
"2011","Spelthorne 010","E02006412","Total",2831,2256,1186,1070,33,197,35,162,317,285,9,17,6,28
"2011","Spelthorne 011","E02006413","Total",2496,1976,989,987,14,313,43,270,177,166,2,7,2,16
"2011","Spelthorne 012","E02006414","Total",2539,2007,955,1052,42,306,41,265,156,139,2,13,2,28
"2011","Spelthorne 013","E02006415","Total",3047,2515,1419,1096,29,83,10,73,385,337,23,15,10,35
"2011","Surrey Heath 001","E02006416","Total",3398,2766,1420,1346,7,242,35,207,320,283,16,19,2,63
"2011","Surrey Heath 002","E02006417","Total",2332,1733,700,1033,4,265,27,238,303,281,9,8,5,27
"2011","Surrey Heath 003","E02006418","Total",2778,2398,1133,1265,5,116,16,100,245,229,1,13,2,14
"2011","Surrey Heath 004","E02006419","Total",3079,1664,682,982,48,878,117,761,459,338,77,13,31,30
"2011","Surrey Heath 005","E02006420","Total",2788,2335,1114,1221,11,36,4,32,380,340,19,14,7,26
"2011","Surrey Heath 006","E02006421","Total",2998,2614,1141,1473,11,77,14,63,257,224,15,9,9,39
"2011","Surrey Heath 007","E02006422","Total",2344,2016,820,1196,9,50,2,48,256,237,4,12,3,13
"2011","Surrey Heath 008","E02006423","Total",4111,2573,1133,1440,99,680,90,590,713,662,20,24,7,46
"2011","Surrey Heath 009","E02006424","Total",2360,2088,1007,1081,9,67,8,59,180,164,1,13,2,16
"2011","Surrey Heath 010","E02006425","Total",2354,1723,812,911,8,367,46,321,226,200,8,13,5,30
"2011","Surrey Heath 011","E02006426","Total",2266,1865,797,1068,35,123,15,108,225,203,8,14,0,18
"2011","Surrey Heath 012","E02006427","Total",2738,1994,909,1085,23,188,20,168,509,259,131,21,98,24
"2011","Tandridge 002","E02006429","Total",3149,2373,1080,1293,108,150,91,59,494,477,2,13,2,24
"2011","Tandridge 003","E02006430","Total",3473,2626,988,1638,51,459,176,283,311,265,9,33,4,26
"2011","Tandridge 004","E02006431","Total",4265,3213,1516,1697,40,317,258,59,621,573,20,24,4,74
"2011","Tandridge 005","E02006432","Total",2193,1789,895,894,5,169,133,36,204,185,3,12,4,26
"2011","Tandridge 006","E02006433","Total",3760,2962,1653,1309,7,282,215,67,453,413,15,23,2,56
"2011","Tandridge 007","E02006434","Total",2358,1663,761,902,16,497,364,133,167,150,7,9,1,15
"2011","Tandridge 008","E02006435","Total",2361,1682,787,895,19,380,270,110,253,224,13,11,5,27
"2011","Tandridge 009","E02006436","Total",2386,1714,776,938,16,401,343,58,221,190,15,12,4,34
"2011","Tandridge 010","E02006437","Total",3199,2405,1215,1190,17,374,319,55,351,256,52,37,6,52
"2011","Tandridge 011","E02006438","Total",3151,2491,1216,1275,18,238,105,133,333,279,16,18,20,71
"2011","Tandridge 012","E02006790","Total",3047,2384,1187,1197,16,343,293,50,258,224,6,19,9,46
"2011","Waverley 001","E02006439","Total",2490,1907,869,1038,35,304,204,100,210,195,4,9,2,34
"2011","Waverley 002","E02006440","Total",2844,2260,1042,1218,5,294,99,195,262,244,0,17,1,23
"2011","Waverley 003","E02006441","Total",3296,1882,1002,880,79,639,459,180,651,609,8,26,8,45
"2011","Waverley 004","E02006442","Total",2290,1955,1097,858,3,71,57,14,222,194,12,12,4,39
"2011","Waverley 005","E02006443","Total",3141,1930,915,1015,54,766,632,134,361,333,4,15,9,30
"2011","Waverley 006","E02006444","Total",2718,2001,945,1056,20,415,354,61,258,239,1,16,2,24
"2011","Waverley 007","E02006445","Total",2995,2056,969,1087,19,122,82,40,728,643,47,32,6,70
"2011","Waverley 008","E02006446","Total",2730,2119,1191,928,11,305,297,8,246,215,14,10,7,49
"2011","Waverley 009","E02006447","Total",2412,1956,976,980,11,180,117,63,226,207,3,14,2,39
"2011","Waverley 010","E02006448","Total",2818,2176,1054,1122,18,373,300,73,233,208,6,18,1,18
"2011","Waverley 011","E02006449","Total",2894,2087,1125,962,60,439,376,63,257,236,5,15,1,51
"2011","Waverley 012","E02006450","Total",2563,1930,1052,878,30,228,183,45,279,208,36,18,17,96
"2011","Waverley 013","E02006451","Total",4372,3248,1781,1467,48,541,402,139,450,372,53,21,4,85
"2011","Waverley 015","E02006453","Total",3235,2480,1427,1053,33,362,264,98,258,212,20,21,5,102
"2011","Waverley 016","E02006454","Total",2766,2049,1098,951,27,392,306,86,266,241,6,17,2,32
"2011","Waverley 017","E02006455","Total",2445,1718,724,994,18,338,307,31,337,309,6,10,12,34
"2011","Waverley 018","E02006839","Total",3271,2541,1305,1236,20,299,223,76,333,301,6,19,7,78
"2011","Woking 001","E02006456","Total",3174,2437,1029,1408,17,378,333,45,315,282,3,30,0,27
"2011","Woking 002","E02006457","Total",3615,2979,1594,1385,3,128,45,83,476,397,43,13,23,29
"2011","Woking 003","E02006458","Total",3498,2820,1437,1383,6,269,108,161,366,346,2,10,8,37
"2011","Woking 004","E02006459","Total",3618,1706,608,1098,40,1049,873,176,777,709,11,43,14,46
"2011","Woking 005","E02006460","Total",3945,2590,942,1648,77,743,627,116,503,473,2,28,0,32
"2011","Woking 006","E02006461","Total",2696,1994,1083,911,15,121,33,88,533,504,9,14,6,33
"2011","Woking 007","E02006462","Total",3339,2415,898,1517,83,319,205,114,497,464,4,27,2,25
"2011","Woking 008","E02006463","Total",4393,2444,1127,1317,49,330,163,167,1517,1465,11,32,9,53
"2011","Woking 009","E02006464","Total",2882,2081,877,1204,26,446,276,170,307,281,4,18,4,22
"2011","Woking 010","E02006465","Total",2509,1966,945,1021,7,140,10,130,376,354,5,16,1,20
"2011","Woking 011","E02006466","Total",3355,2286,938,1348,30,691,592,99,319,286,6,20,7,29
"2011","Woking 012","E02006467","Total",2443,2111,1001,1110,15,90,43,47,200,184,5,7,4,27
"2011","Adur 001","E02006534","Total",3544,2816,1437,1379,9,397,382,15,295,253,3,36,3,27
"2011","Adur 002","E02006535","Total",2829,2527,1314,1213,9,70,49,21,196,171,0,25,0,27
"2011","Adur 003","E02006536","Total",2875,2418,1189,1229,16,139,119,20,236,202,11,19,4,66
"2011","Adur 004","E02006537","Total",4304,2457,1127,1330,36,1279,966,313,481,432,2,43,4,51
"2011","Adur 005","E02006538","Total",4059,2888,1467,1421,49,289,163,126,790,731,4,49,6,43
"2011","Adur 006","E02006539","Total",3132,2289,1179,1110,6,520,455,65,280,235,3,42,0,37
"2011","Adur 007","E02006540","Total",2589,1840,978,862,8,456,228,228,265,236,2,23,4,20
"2011","Adur 008","E02006541","Total",3625,2648,1500,1148,21,373,290,83,536,502,4,29,1,47
"2011","Arun 001","E02006542","Total",2629,1858,1112,746,9,237,143,94,433,382,16,21,14,92
"2011","Arun 002","E02006543","Total",2432,1863,1043,820,9,233,204,29,276,238,11,23,4,51
"2011","Arun 003","E02006544","Total",4128,3355,1722,1633,26,302,228,74,398,351,6,37,4,47
"2011","Arun 004","E02006545","Total",3458,2161,1003,1158,90,754,490,264,416,379,5,30,2,37
"2011","Arun 005","E02006546","Total",4201,3124,1721,1403,54,569,318,251,401,357,7,26,11,53
"2011","Arun 006","E02006547","Total",2300,1739,855,884,35,298,161,137,196,164,6,25,1,32
"2011","Arun 007","E02006548","Total",4133,3256,1612,1644,61,246,96,150,538,500,5,29,4,32
"2011","Arun 008","E02006549","Total",2864,2606,1861,745,2,34,31,3,201,185,1,14,1,21
"2011","Arun 009","E02006550","Total",4118,3349,1991,1358,18,332,159,173,383,338,2,39,4,36
"2011","Arun 010","E02006551","Total",4049,3413,2505,908,19,166,39,127,410,371,1,33,5,41
"2011","Arun 011","E02006552","Total",3462,1632,878,754,38,218,65,153,1533,1480,10,32,11,41
"2011","Arun 012","E02006553","Total",3139,2517,1261,1256,36,172,85,87,379,342,0,34,3,35
"2011","Arun 013","E02006554","Total",3140,2564,1556,1008,10,177,133,44,343,314,1,25,3,46
"2011","Arun 014","E02006555","Total",3164,1827,841,986,35,669,397,272,597,552,0,37,8,36
"2011","Arun 015","E02006556","Total",3659,3223,2019,1204,5,55,40,15,358,332,1,22,3,18
"2011","Arun 016","E02006557","Total",2828,1571,626,945,37,689,413,276,499,462,2,30,5,32
"2011","Arun 017","E02006558","Total",4850,2166,1292,874,52,383,143,240,2179,2086,10,66,17,70
"2011","Arun 018","E02006559","Total",3831,3455,2427,1028,9,25,1,24,322,288,3,24,7,20
"2011","Arun 019","E02006560","Total",4321,3575,2256,1319,21,327,79,248,349,306,8,32,3,49
"2011","Chichester 001","E02006561","Total",2636,1924,983,941,33,381,61,320,248,211,13,20,4,50
"2011","Chichester 002","E02006562","Total",2387,1900,1055,845,10,234,30,204,177,150,7,15,5,66
"2011","Chichester 003","E02006563","Total",2392,1689,1017,672,7,316,43,273,303,257,29,15,2,77
"2011","Chichester 004","E02006564","Total",3424,2155,1336,819,37,673,108,565,491,437,13,28,13,68
"2011","Chichester 005","E02006565","Total",3502,2139,1325,814,21,508,84,424,649,542,55,30,22,185
"2011","Chichester 006","E02006566","Total",3356,2299,1492,807,36,481,73,408,439,372,40,19,8,101
"2011","Chichester 007","E02006567","Total",3149,2350,1401,949,22,377,78,299,324,282,20,13,9,76
"2011","Chichester 008","E02006568","Total",4791,2077,1217,860,90,1494,211,1283,1040,848,60,56,76,90
"2011","Chichester 009","E02006569","Total",3197,2270,1480,790,19,224,25,199,634,414,102,26,92,50
"2011","Chichester 010","E02006570","Total",4130,2244,1375,869,27,738,92,646,1062,988,17,46,11,59
"2011","Chichester 011","E02006571","Total",3343,2614,1520,1094,23,280,56,224,391,360,7,20,4,35
"2011","Chichester 012","E02006572","Total",3807,2299,1170,1129,59,924,149,775,461,405,14,36,6,64
"2011","Chichester 013","E02006573","Total",4871,3718,2455,1263,45,377,43,334,629,569,16,36,8,102
"2011","Chichester 014","E02006574","Total",4863,3803,2384,1419,26,400,31,369,575,521,10,37,7,59
"2011","Crawley 001","E02006575","Total",2942,1617,651,966,46,882,631,251,355,333,1,15,6,42
"2011","Crawley 002","E02006576","Total",3228,2556,1074,1482,23,224,179,45,410,388,3,15,4,15
"2011","Crawley 003","E02006577","Total",3301,1686,725,961,47,1104,1024,80,384,348,1,30,5,80
"2011","Crawley 004","E02006578","Total",4141,2150,912,1238,124,966,722,244,855,797,11,37,10,46
"2011","Crawley 005","E02006579","Total",3269,1974,918,1056,51,637,507,130,567,539,3,17,8,40
"2011","Crawley 006","E02006580","Total",3281,2211,871,1340,31,654,564,90,354,325,3,21,5,31
"2011","Crawley 007","E02006581","Total",3650,1999,886,1113,41,827,461,366,740,690,13,28,9,43
"2011","Crawley 008","E02006582","Total",3008,2372,723,1649,59,106,14,92,459,435,3,20,1,12
"2011","Crawley 009","E02006583","Total",3809,2534,989,1545,22,612,526,86,588,539,0,44,5,53
"2011","Crawley 010","E02006584","Total",2900,1335,275,1060,40,1184,1149,35,310,289,1,19,1,31
"2011","Crawley 011","E02006585","Total",3096,1856,769,1087,25,912,855,57,255,235,1,18,1,48
"2011","Crawley 012","E02006586","Total",2662,1490,340,1150,23,731,697,34,394,366,1,25,2,24
"2011","Crawley 013","E02006587","Total",3440,1448,347,1101,56,1355,625,730,543,505,2,30,6,38
"2011","Horsham 001","E02006588","Total",3198,2115,944,1171,19,531,30,501,484,431,21,27,5,49
"2011","Horsham 002","E02006589","Total",4465,3755,1691,2064,38,271,11,260,380,354,5,19,2,21
"2011","Horsham 003","E02006590","Total",3646,2504,1176,1328,21,510,57,453,561,507,16,32,6,50
"2011","Horsham 004","E02006591","Total",3428,2434,1157,1277,21,371,40,331,565,529,3,30,3,37
"2011","Horsham 005","E02006592","Total",2430,1873,959,914,22,250,24,226,233,175,36,15,7,52
"2011","Horsham 006","E02006593","Total",4697,2655,1281,1374,36,1122,114,1008,826,771,12,37,6,58
"2011","Horsham 007","E02006594","Total",2892,2252,1035,1217,21,304,46,258,293,271,1,17,4,22
"2011","Horsham 008","E02006595","Total",3154,2529,1415,1114,11,145,14,131,350,278,44,18,10,119
"2011","Horsham 009","E02006596","Total",3342,2745,979,1766,58,270,18,252,257,218,4,30,5,12
"2011","Horsham 010","E02006597","Total",3945,2883,1376,1507,38,501,44,457,453,403,18,27,5,70
"2011","Horsham 011","E02006598","Total",2184,1738,802,936,3,149,12,137,242,213,9,15,5,52
"2011","Horsham 012","E02006599","Total",3049,2716,1725,991,11,95,10,85,183,155,11,11,6,44
"2011","Horsham 013","E02006600","Total",4324,2883,1635,1248,15,862,116,746,498,427,17,36,18,66
"2011","Horsham 014","E02006601","Total",3464,2427,1391,1036,16,570,75,495,405,352,14,32,7,46
"2011","Horsham 015","E02006602","Total",2921,2312,1112,1200,21,211,33,178,317,282,10,18,7,60
"2011","Horsham 016","E02006603","Total",3784,3105,1808,1297,12,185,28,157,433,406,1,23,3,49
"2011","Mid Sussex 001","E02006604","Total",5493,3378,1546,1832,58,1025,82,943,966,911,7,40,8,66
"2011","Mid Sussex 002","E02006605","Total",2429,1870,872,998,15,156,4,152,326,291,17,13,5,62
"2011","Mid Sussex 003","E02006606","Total",3310,2742,1175,1567,36,99,7,92,405,368,3,32,2,28
"2011","Mid Sussex 004","E02006607","Total",2981,2578,1291,1287,6,106,8,98,260,234,5,19,2,31
"2011","Mid Sussex 005","E02006608","Total",2343,2045,1064,981,13,131,7,124,139,126,1,9,3,15
"2011","Mid Sussex 006","E02006609","Total",2729,2022,1108,914,8,298,13,285,314,255,35,13,11,87
"2011","Mid Sussex 007","E02006610","Total",2784,1869,890,979,33,318,11,307,444,395,19,17,13,120
"2011","Mid Sussex 008","E02006611","Total",4165,3526,1912,1614,6,197,7,190,383,353,8,18,4,53
"2011","Mid Sussex 009","E02006612","Total",4656,2760,1131,1629,64,423,13,410,1357,1292,10,50,5,52
"2011","Mid Sussex 010","E02006613","Total",3028,1863,814,1049,61,783,33,750,299,284,3,11,1,22
"2011","Mid Sussex 011","E02006614","Total",4149,3040,1533,1507,65,543,20,523,453,414,5,29,5,48
"2011","Mid Sussex 012","E02006615","Total",2608,2069,675,1394,56,214,10,204,265,249,0,14,2,4
"2011","Mid Sussex 013","E02006616","Total",3264,2698,1272,1426,37,265,19,246,242,218,3,21,0,22
"2011","Mid Sussex 014","E02006617","Total",3877,2447,1008,1439,49,746,36,710,605,557,9,33,6,30
"2011","Mid Sussex 015","E02006618","Total",2377,2189,1125,1064,7,21,2,19,145,132,2,11,0,15
"2011","Mid Sussex 016","E02006619","Total",3192,2255,1035,1220,30,439,13,426,391,336,19,26,10,77
"2011","Mid Sussex 017","E02006620","Total",4024,3307,1957,1350,17,328,10,318,328,304,3,19,2,44
"2011","Worthing 001","E02006621","Total",3330,3049,1782,1267,6,60,11,49,185,158,3,22,2,30
"2011","Worthing 002","E02006622","Total",3466,2697,1373,1324,11,333,39,294,401,370,0,27,4,24
"2011","Worthing 003","E02006623","Total",3340,2325,1094,1231,8,620,114,506,361,323,1,35,2,26
"2011","Worthing 004","E02006624","Total",2862,2524,1227,1297,6,16,2,14,297,273,3,19,2,19
"2011","Worthing 005","E02006625","Total",3295,2532,964,1568,32,165,24,141,549,496,2,44,7,17
"2011","Worthing 006","E02006626","Total",3001,1762,678,1084,21,866,213,653,310,275,7,20,8,42
"2011","Worthing 007","E02006627","Total",3758,2880,1467,1413,13,411,111,300,430,401,2,22,5,24
"2011","Worthing 008","E02006628","Total",3969,2366,871,1495,13,496,98,398,1055,983,6,58,8,39
"2011","Worthing 009","E02006629","Total",3391,2115,952,1163,13,599,199,400,631,581,4,38,8,33
"2011","Worthing 010","E02006630","Total",4164,2136,1137,999,31,438,54,384,1513,1418,3,74,18,46
"2011","Worthing 011","E02006631","Total",4945,2111,1061,1050,45,427,60,367,2314,2162,30,92,30,48
"2011","Worthing 012","E02006632","Total",3783,2902,1630,1272,8,108,16,92,734,695,0,36,3,31
"2011","Worthing 013","E02006633","Total",3740,3222,2137,1085,10,156,47,109,322,289,4,27,2,30
"2011","Bath and North East Somerset 001","E02002985","Total",2176,1505,755,750,7,387,116,271,236,208,3,25,0,41
"2011","Bath and North East Somerset 002","E02002986","Total",2307,1454,775,679,18,596,176,420,202,169,1,27,5,37
"2011","Bath and North East Somerset 003","E02002987","Total",2324,2002,1208,794,7,97,13,84,202,179,4,14,5,16
"2011","Bath and North East Somerset 004","E02002988","Total",2412,1663,871,792,20,292,62,230,410,369,3,32,6,27
"2011","Bath and North East Somerset 005","E02002989","Total",2306,1630,944,686,4,351,77,274,298,267,2,23,6,23
"2011","Bath and North East Somerset 006","E02002990","Total",2828,1609,767,842,9,358,90,268,827,784,1,34,8,25
"2011","Bath and North East Somerset 007","E02002991","Total",5472,2195,1297,898,32,996,119,877,2141,1996,18,89,38,108
"2011","Bath and North East Somerset 008","E02002992","Total",2483,1587,793,794,21,388,44,344,463,424,4,29,6,24
"2011","Bath and North East Somerset 009","E02002993","Total",2666,1074,544,530,7,542,74,468,999,944,6,31,18,44
"2011","Bath and North East Somerset 010","E02002994","Total",4279,3376,1976,1400,6,335,69,266,466,408,12,39,7,96
"2011","Bath and North East Somerset 011","E02002995","Total",2273,925,377,548,6,1098,328,770,209,182,2,24,1,35
"2011","Bath and North East Somerset 012","E02002996","Total",3500,2262,1407,855,18,154,36,118,1013,967,9,30,7,53
"2011","Bath and North East Somerset 013","E02002997","Total",2216,1257,644,613,8,185,56,129,744,690,4,46,4,22
"2011","Bath and North East Somerset 014","E02002998","Total",2277,1183,595,588,24,490,124,366,554,511,3,33,7,26
"2011","Bath and North East Somerset 015","E02002999","Total",2327,1505,786,719,21,533,170,363,237,210,1,20,6,31
"2011","Bath and North East Somerset 016","E02003000","Total",3830,3094,1768,1326,11,406,91,315,260,226,4,21,9,59
"2011","Bath and North East Somerset 017","E02003001","Total",2240,1717,968,749,14,162,12,150,324,307,1,16,0,23
"2011","Bath and North East Somerset 018","E02003002","Total",2336,1409,806,603,4,630,201,429,267,251,0,14,2,26
"2011","Bath and North East Somerset 019","E02003003","Total",2364,1534,724,810,46,418,101,317,341,313,1,23,4,25
"2011","Bath and North East Somerset 020","E02003004","Total",2392,1903,911,992,7,238,48,190,209,190,4,12,3,35
"2011","Bath and North East Somerset 021","E02003005","Total",2479,1997,1152,845,13,199,43,156,226,182,18,20,6,44
"2011","Bath and North East Somerset 022","E02003006","Total",3473,2581,1168,1413,25,342,87,255,475,430,9,22,14,50
"2011","Bath and North East Somerset 023","E02003007","Total",3371,2698,1373,1325,12,304,91,213,323,284,5,28,6,34
"2011","Bath and North East Somerset 024","E02003008","Total",2300,1515,604,911,6,476,132,344,267,238,4,22,3,36
"2011","Bath and North East Somerset 025","E02003009","Total",2455,1967,909,1058,4,114,34,80,347,317,5,23,2,23
"2011","Bath and North East Somerset 026","E02003010","Total",2299,1798,771,1027,16,227,72,155,230,200,3,26,1,28
"2011","Bath and North East Somerset 027","E02003011","Total",2130,1628,934,694,2,296,62,234,177,162,1,12,2,27
"2011","Bournemouth 001","E02003172","Total",2688,1804,985,819,17,552,348,204,275,245,1,27,2,40
"2011","Bournemouth 002","E02003173","Total",3027,2040,1089,951,9,627,541,86,309,276,3,30,0,42
"2011","Bournemouth 003","E02003174","Total",3486,2828,1517,1311,15,170,105,65,441,399,1,35,6,32
"2011","Bournemouth 004","E02003175","Total",3750,2807,1200,1607,42,291,164,127,582,527,3,49,3,28
"2011","Bournemouth 005","E02003176","Total",2976,1263,522,741,30,1365,1123,242,274,247,1,22,4,44
"2011","Bournemouth 006","E02003177","Total",3188,2606,1118,1488,13,57,15,42,483,438,2,37,6,29
"2011","Bournemouth 007","E02003178","Total",3417,2253,1004,1249,15,533,411,122,574,518,4,39,13,42
"2011","Bournemouth 008","E02003179","Total",2766,1496,737,759,23,954,703,251,257,229,0,22,6,36
"2011","Bournemouth 009","E02003180","Total",3617,1794,715,1079,20,404,162,242,1366,1290,4,63,9,33
"2011","Bournemouth 010","E02003181","Total",3341,2405,1015,1390,5,134,24,110,769,707,1,57,4,28
"2011","Bournemouth 011","E02003182","Total",2689,2064,994,1070,3,91,42,49,509,411,46,21,31,22
"2011","Bournemouth 012","E02003183","Total",2765,1847,994,853,6,138,12,126,751,718,5,23,5,23
"2011","Bournemouth 013","E02003184","Total",3171,1563,559,1004,38,116,28,88,1429,1346,5,62,16,25
"2011","Bournemouth 014","E02003185","Total",3035,2173,916,1257,10,352,194,158,459,420,2,32,5,41
"2011","Bournemouth 015","E02003186","Total",3684,1794,628,1166,22,397,86,311,1444,1381,2,48,13,27
"2011","Bournemouth 016","E02003187","Total",4015,2232,996,1236,34,281,22,259,1433,1355,3,66,9,35
"2011","Bournemouth 017","E02003188","Total",5433,1955,982,973,23,825,310,515,2579,2455,8,84,32,51
"2011","Bournemouth 018","E02003189","Total",3935,2362,1223,1139,10,295,44,251,1235,1162,4,63,6,33
"2011","Bournemouth 019","E02003190","Total",5441,1494,643,851,69,489,172,317,3344,3244,10,77,13,45
"2011","Bournemouth 020","E02003191","Total",3840,2903,1832,1071,11,155,24,131,735,695,2,36,2,36
"2011","Bournemouth 021","E02003192","Total",5008,1811,1105,706,38,529,192,337,2551,2439,23,75,14,79
"2011","Bournemouth 023","E02006883","Total",3204,1486,775,711,24,354,167,187,1302,1237,3,54,8,38
"2011","Bournemouth 024","E02006885","Total",3898,2077,1271,806,92,97,6,91,1584,1495,5,78,6,48
"2011","Bristol 001","E02003012","Total",4806,2537,1195,1342,31,1608,1442,166,529,494,3,24,8,101
"2011","Bristol 002","E02003013","Total",4850,2419,1040,1379,48,1662,1446,216,632,578,1,43,10,89
"2011","Bristol 003","E02003014","Total",3331,1302,618,684,6,1745,1457,288,227,199,3,21,4,51
"2011","Bristol 004","E02003015","Total",2436,1421,722,699,15,596,512,84,368,338,7,23,0,36
"2011","Bristol 005","E02003016","Total",3059,1217,445,772,76,986,505,481,747,702,4,32,9,33
"2011","Bristol 006","E02003017","Total",2736,1920,1035,885,12,361,280,81,398,367,3,25,3,45
"2011","Bristol 007","E02003018","Total",2393,1482,734,748,8,669,605,64,201,174,6,11,10,33
"2011","Bristol 008","E02003019","Total",3995,2475,1125,1350,18,890,756,134,558,513,4,36,5,54
"2011","Bristol 009","E02003020","Total",2504,2131,1220,911,9,157,35,122,184,165,2,6,11,23
"2011","Bristol 010","E02003021","Total",2670,1663,714,949,32,172,141,31,781,740,2,37,2,22
"2011","Bristol 011","E02003022","Total",2389,2200,1288,912,0,24,12,12,152,139,0,11,2,13
"2011","Bristol 012","E02003023","Total",2630,1669,861,808,10,504,359,145,386,354,5,24,3,61
"2011","Bristol 013","E02003024","Total",3599,2085,1103,982,24,783,549,234,653,600,1,46,6,54
"2011","Bristol 014","E02003025","Total",2726,1461,665,796,12,758,656,102,432,396,1,34,1,63
"2011","Bristol 015","E02003026","Total",3241,2678,1601,1077,1,110,97,13,404,381,2,19,2,48
"2011","Bristol 016","E02003027","Total",4578,3104,1223,1881,22,157,74,83,1266,1212,5,43,6,29
"2011","Bristol 017","E02003028","Total",3430,2258,1016,1242,5,216,61,155,915,876,7,17,15,36
"2011","Bristol 018","E02003029","Total",2448,1394,578,816,3,661,555,106,346,307,0,29,10,44
"2011","Bristol 019","E02003030","Total",3088,1802,727,1075,29,308,125,183,905,848,6,40,11,44
"2011","Bristol 020","E02003031","Total",4083,2182,910,1272,5,170,45,125,1691,1618,6,53,14,35
"2011","Bristol 021","E02003032","Total",3083,1895,818,1077,44,415,260,155,686,628,3,52,3,43
"2011","Bristol 022","E02003033","Total",3613,1453,686,767,11,175,37,138,1948,1893,3,48,4,26
"2011","Bristol 023","E02003034","Total",5569,1812,740,1072,103,1853,672,1181,1713,1605,3,90,15,88
"2011","Bristol 025","E02003036","Total",3913,1141,510,631,23,669,377,292,2025,1915,21,60,29,55
"2011","Bristol 026","E02003037","Total",4038,1633,756,877,11,120,27,93,2226,2152,5,61,8,48
"2011","Bristol 027","E02003038","Total",2795,1790,763,1027,19,339,190,149,616,574,4,33,5,31
"2011","Bristol 028","E02003039","Total",3518,2016,822,1194,15,671,466,205,769,736,0,31,2,47
"2011","Bristol 029","E02003040","Total",4392,2182,734,1448,26,440,283,157,1694,1632,4,51,7,50
"2011","Bristol 030","E02003041","Total",2979,1313,736,577,13,106,28,78,1480,1420,19,34,7,67
"2011","Bristol 032","E02003043","Total",4647,1154,568,586,88,743,245,498,2581,2404,47,84,46,81
"2011","Bristol 033","E02003044","Total",2513,1906,845,1061,9,105,49,56,478,436,1,40,1,15
"2011","Bristol 034","E02003045","Total",2988,1233,602,631,25,469,214,255,1218,1154,4,41,19,43
"2011","Bristol 035","E02003046","Total",4107,2583,898,1685,52,536,292,244,899,825,5,61,8,37
"2011","Bristol 036","E02003047","Total",4474,2440,970,1470,24,725,487,238,1246,1181,5,50,10,39
"2011","Bristol 037","E02003048","Total",3212,1586,544,1042,101,428,125,303,1074,1021,2,47,4,23
"2011","Bristol 038","E02003049","Total",3122,2123,971,1152,14,548,511,37,404,372,2,29,1,33
"2011","Bristol 039","E02003050","Total",4322,1783,746,1037,53,889,545,344,1532,1445,3,69,15,65
"2011","Bristol 040","E02003051","Total",2831,1517,558,959,23,600,486,114,643,606,1,34,2,48
"2011","Bristol 041","E02003052","Total",2835,2026,935,1091,11,258,237,21,516,483,0,32,1,24
"2011","Bristol 042","E02003053","Total",3342,2451,1144,1307,8,330,173,157,533,481,0,42,10,20
"2011","Bristol 043","E02003054","Total",2698,1897,839,1058,10,363,297,66,410,381,2,24,3,18
"2011","Bristol 044","E02003055","Total",3118,1521,619,902,42,1217,1086,131,281,257,0,22,2,57
"2011","Bristol 045","E02003056","Total",2841,1302,535,767,10,1175,1074,101,281,259,2,19,1,73
"2011","Bristol 046","E02003057","Total",2434,1790,912,878,18,292,244,48,295,270,2,22,1,39
"2011","Bristol 047","E02003058","Total",3836,2460,1086,1374,33,794,502,292,509,463,2,41,3,40
"2011","Bristol 048","E02003059","Total",2374,1587,828,759,12,536,423,113,212,183,4,21,4,27
"2011","Bristol 049","E02003060","Total",4591,3223,1631,1592,20,930,685,245,378,334,0,39,5,40
"2011","Bristol 050","E02003061","Total",2481,1164,551,613,12,1053,864,189,196,165,1,24,6,56
"2011","Bristol 051","E02003062","Total",2435,1092,526,566,8,1123,893,230,161,138,0,19,4,51
"2011","Bristol 052","E02003063","Total",2947,2609,1409,1200,10,98,82,16,207,179,0,26,2,23
"2011","Bristol 053","E02003064","Total",2834,921,432,489,22,1698,1531,167,126,109,2,11,4,67
"2011","Bristol 054","E02006887","Total",3380,522,143,379,87,1354,932,422,1332,1287,10,24,11,85
"2011","Bristol 055","E02006888","Total",2857,894,386,508,20,1008,644,364,878,827,2,38,11,57
"2011","Bristol 056","E02006889","Total",3015,552,217,335,13,1908,1571,337,477,442,2,18,15,65
"2011","Bristol 057","E02006890","Total",3621,1737,648,1089,29,578,250,328,1229,1143,3,73,10,48
"2011","Cornwall 010","E02003892","Total",2769,2159,1314,845,30,236,167,69,299,261,1,28,9,45
"2011","Cornwall 012","E02003893","Total",2819,2205,1281,924,18,219,177,42,321,269,4,42,6,56
"2011","Cornwall 013","E02003894","Total",3479,2436,1340,1096,50,379,208,171,558,499,3,52,4,56
"2011","Cornwall 016","E02003895","Total",3379,2290,1257,1033,27,447,227,220,576,506,8,53,9,39
"2011","Cornwall 017","E02003896","Total",2608,1444,778,666,11,589,485,104,508,471,1,33,3,56
"2011","Cornwall 022","E02003897","Total",2228,1839,926,913,19,51,30,21,296,250,15,24,7,23
"2011","Cornwall 023","E02003898","Total",2879,2133,1268,865,7,257,210,47,430,384,7,27,12,52
"2011","Cornwall 025","E02003899","Total",2372,1588,810,778,26,502,433,69,221,195,2,22,2,35
"2011","Cornwall 026","E02003900","Total",3090,2280,1085,1195,33,345,222,123,407,363,1,39,4,25
"2011","Cornwall 028","E02003901","Total",3369,2258,1488,770,17,517,451,66,488,407,13,57,11,89
"2011","Cornwall 029","E02003902","Total",2383,1506,780,726,5,430,294,136,416,313,44,34,25,26
"2011","Cornwall 034","E02003903","Total",2872,2078,1160,918,17,337,243,94,392,343,12,29,8,48
"2011","Cornwall 037","E02003904","Total",2509,1864,1173,691,9,185,136,49,405,354,7,37,7,46
"2011","Cornwall 032","E02003905","Total",2556,1911,988,923,23,152,102,50,439,383,10,40,6,31
"2011","Cornwall 033","E02003906","Total",2362,1741,1042,699,8,182,116,66,368,318,5,37,8,63
"2011","Cornwall 040","E02003907","Total",3404,2498,1512,986,41,246,144,102,559,470,10,72,7,60
"2011","Cornwall 042","E02003908","Total",3387,2191,1177,1014,38,656,465,191,451,417,5,27,2,51
"2011","Cornwall 043","E02003909","Total",3914,2595,1443,1152,27,635,487,148,609,543,11,44,11,48
"2011","Cornwall 044","E02003910","Total",3002,1697,1001,696,49,435,208,227,758,688,6,54,10,63
"2011","Cornwall 047","E02003911","Total",3594,2781,1752,1029,23,195,158,37,520,482,3,30,5,75
"2011","Cornwall 048","E02003912","Total",3496,2472,1615,857,34,362,251,111,527,452,26,37,12,101
"2011","Cornwall 056","E02003913","Total",2564,1994,1327,667,8,186,160,26,320,267,7,26,20,56
"2011","Cornwall 060","E02003914","Total",3146,1825,899,926,34,525,357,168,725,680,1,41,3,37
"2011","Cornwall 062","E02003915","Total",3308,1582,888,694,9,1006,867,139,634,567,2,57,8,77
"2011","Cornwall 063","E02003916","Total",3034,1738,1135,603,36,173,41,132,1031,956,9,51,15,56
"2011","Cornwall 064","E02003917","Total",3167,2536,1377,1159,15,214,116,98,370,325,8,34,3,32
"2011","Cornwall 045","E02003918","Total",2969,2253,1267,986,13,281,97,184,381,339,4,36,2,41
"2011","Cornwall 046","E02003919","Total",2998,1605,804,801,11,778,261,517,545,503,2,34,6,59
"2011","Cornwall 049","E02003920","Total",3093,2222,1112,1110,28,133,24,109,677,621,2,43,11,33
"2011","Cornwall 050","E02003921","Total",2517,1939,1134,805,13,222,49,173,320,282,3,31,4,23
"2011","Cornwall 051","E02003922","Total",3262,2280,1151,1129,28,444,71,373,480,425,3,48,4,30
"2011","Cornwall 052","E02003923","Total",3090,2064,1162,902,11,252,73,179,733,677,3,48,5,30
"2011","Cornwall 053","E02003924","Total",3123,1979,1201,778,11,533,184,349,556,494,4,49,9,44
"2011","Cornwall 055","E02003925","Total",2892,1966,1056,910,25,497,153,344,368,330,1,35,2,36
"2011","Cornwall 059","E02003926","Total",3117,2492,1367,1125,12,160,52,108,406,359,3,39,5,47
"2011","Cornwall 066","E02003927","Total",3674,2845,1856,989,31,273,83,190,455,368,14,33,40,70
"2011","Cornwall 071","E02003928","Total",4916,3219,1596,1623,26,562,126,436,1048,729,172,62,85,61
"2011","Cornwall 072","E02003929","Total",2957,2227,1410,817,13,289,66,223,374,326,8,35,5,54
"2011","Cornwall 073","E02003930","Total",3600,2601,1759,842,23,401,97,304,495,402,22,60,11,80
"2011","Cornwall 001","E02003931","Total",4484,2966,1886,1080,86,584,267,317,793,729,2,57,5,55
"2011","Cornwall 002","E02003932","Total",2853,2170,1448,722,10,236,166,70,352,308,7,36,1,85
"2011","Cornwall 003","E02003933","Total",3078,2329,1528,801,19,224,133,91,445,382,4,49,10,61
"2011","Cornwall 004","E02003934","Total",2734,1969,1216,753,15,274,170,104,416,359,9,41,7,60
"2011","Cornwall 005","E02003935","Total",3926,2280,1130,1150,32,623,410,213,941,869,9,59,4,50
"2011","Cornwall 006","E02003936","Total",3414,2670,1658,1012,18,167,121,46,478,423,6,43,6,81
"2011","Cornwall 007","E02003937","Total",2396,1643,1166,477,9,293,204,89,370,307,19,40,4,81
"2011","Cornwall 008","E02003938","Total",2810,1870,1201,669,13,412,288,124,452,363,30,47,12,63
"2011","Cornwall 009","E02003939","Total",2955,2009,1228,781,31,423,302,121,450,395,5,48,2,42
"2011","Cornwall 011","E02003940","Total",2553,1956,1317,639,8,214,150,64,314,269,6,34,5,61
"2011","Cornwall 014","E02003941","Total",3098,1991,1008,983,14,410,235,175,648,592,10,40,6,35
"2011","Cornwall 015","E02003942","Total",3148,1780,883,897,11,848,689,159,476,421,11,40,4,33
"2011","Cornwall 054","E02003943","Total",3445,2207,1378,829,36,573,76,497,564,497,9,49,9,65
"2011","Cornwall 057","E02003944","Total",4031,2740,1564,1176,60,637,103,534,541,476,9,50,6,53
"2011","Cornwall 058","E02003945","Total",2656,2120,1352,768,20,59,11,48,423,376,8,34,5,34
"2011","Cornwall 061","E02003946","Total",3714,2639,1607,1032,48,387,63,324,559,485,5,61,8,81
"2011","Cornwall 065","E02003947","Total",2753,1968,1237,731,17,260,27,233,447,380,11,50,6,61
"2011","Cornwall 067","E02003948","Total",3685,2158,1336,822,20,893,98,795,554,509,3,38,4,60
"2011","Cornwall 068","E02003949","Total",3472,1709,991,718,8,706,104,602,983,892,10,67,14,66
"2011","Cornwall 069","E02003950","Total",2429,1668,1042,626,16,287,30,257,395,349,3,37,6,63
"2011","Cornwall 070","E02003951","Total",2920,2057,1404,653,9,342,52,290,443,394,6,39,4,69
"2011","Cornwall 018","E02003952","Total",2853,1897,1014,883,12,285,60,225,602,457,64,48,33,57
"2011","Cornwall 019","E02003953","Total",4232,2993,1635,1358,42,368,84,284,760,657,10,82,11,69
"2011","Cornwall 020","E02003954","Total",3091,1732,887,845,20,349,46,303,945,859,7,63,16,45
"2011","Cornwall 021","E02003955","Total",4032,2692,1336,1356,31,394,76,318,847,735,37,60,15,68
"2011","Cornwall 024","E02003956","Total",2884,1918,999,919,53,369,77,292,507,459,9,38,1,37
"2011","Cornwall 027","E02003957","Total",4192,3002,1694,1308,25,375,104,271,737,678,8,46,5,53
"2011","Cornwall 030","E02003958","Total",3180,2301,1197,1104,42,300,85,215,512,456,3,43,10,25
"2011","Cornwall 031","E02003959","Total",2841,1897,962,935,11,449,120,329,439,376,4,52,7,45
"2011","Cornwall 035","E02003960","Total",2577,1949,1242,707,11,164,43,121,420,386,2,26,6,33
"2011","Cornwall 036","E02003961","Total",3866,3001,1664,1337,63,307,57,250,449,396,4,46,3,46
"2011","Cornwall 038","E02003962","Total",2587,1882,1037,845,37,152,44,108,491,441,6,42,2,25
"2011","Cornwall 039","E02003963","Total",4195,2439,1423,1016,37,858,200,658,793,724,1,55,13,68
"2011","Cornwall 041","E02003964","Total",3407,2589,1752,837,14,147,47,100,593,521,16,45,11,64
"2011","Isles of Scilly 001","E02006781","Total",989,412,313,99,8,179,121,58,294,204,36,13,41,96
"2011","North Somerset 001","E02003065","Total",3960,2714,1268,1446,57,495,149,346,659,615,2,39,3,35
"2011","North Somerset 002","E02003066","Total",2613,2354,1300,1054,7,64,13,51,172,158,0,13,1,16
"2011","North Somerset 003","E02003067","Total",3174,2506,1073,1433,46,245,50,195,345,314,0,30,1,32
"2011","North Somerset 004","E02003068","Total",2671,2075,1133,942,2,308,148,160,241,215,6,13,7,45
"2011","North Somerset 005","E02003069","Total",2390,1979,1165,814,5,39,2,37,345,318,4,18,5,22
"2011","North Somerset 006","E02003070","Total",4942,4050,1969,2081,66,354,108,246,423,352,21,30,20,49
"2011","North Somerset 007","E02003071","Total",3521,2335,1194,1141,29,553,166,387,560,510,8,37,5,44
"2011","North Somerset 008","E02003072","Total",4127,3281,1887,1394,12,399,157,242,396,358,4,30,4,39
"2011","North Somerset 009","E02003073","Total",2651,2341,1233,1108,5,90,29,61,197,176,0,18,3,18
"2011","North Somerset 010","E02003074","Total",3448,2749,1180,1569,21,136,52,84,527,477,1,47,2,15
"2011","North Somerset 011","E02003075","Total",2288,1954,1061,893,3,128,56,72,179,157,4,17,1,24
"2011","North Somerset 012","E02003076","Total",3761,2989,1439,1550,33,314,103,211,379,332,2,40,5,46
"2011","North Somerset 013","E02003077","Total",2491,2012,1132,880,15,124,54,70,309,262,5,39,3,31
"2011","North Somerset 014","E02003078","Total",2756,2183,1092,1091,7,194,79,115,342,302,2,30,8,30
"2011","North Somerset 015","E02003079","Total",3905,3037,1175,1862,40,194,82,112,592,533,2,52,5,42
"2011","North Somerset 016","E02003080","Total",3917,2921,1669,1252,24,421,142,279,503,450,2,47,4,48
"2011","North Somerset 017","E02003081","Total",4126,3441,1915,1526,10,206,106,100,427,379,2,43,3,42
"2011","North Somerset 018","E02003082","Total",4453,2580,1444,1136,6,179,36,143,1647,1565,3,70,9,41
"2011","North Somerset 020","E02003084","Total",4665,2179,1113,1066,19,504,160,344,1905,1806,13,77,9,58
"2011","North Somerset 021","E02003085","Total",3307,1114,402,712,28,1626,890,736,461,434,2,24,1,78
"2011","North Somerset 022","E02003086","Total",2810,1736,923,813,6,214,6,208,828,786,2,35,5,26
"2011","North Somerset 023","E02003087","Total",4029,3381,1932,1449,10,212,109,103,391,339,2,43,7,35
"2011","North Somerset 024","E02003088","Total",3451,2744,1645,1099,15,232,89,143,413,356,30,21,6,47
"2011","North Somerset 025","E02003089","Total",2532,1800,1061,739,12,392,227,165,290,245,6,38,1,38
"2011","North Somerset 026","E02006845","Total",3352,2275,712,1563,42,254,53,201,753,696,4,47,6,28
"2011","North Somerset 027","E02006846","Total",2887,1635,357,1278,22,226,38,188,986,923,2,60,1,18
"2011","Plymouth 001","E02003122","Total",2843,2367,1461,906,29,125,61,64,297,166,66,19,46,25
"2011","Plymouth 002","E02003123","Total",3508,2034,903,1131,31,1092,631,461,318,288,3,24,3,33
"2011","Plymouth 003","E02003124","Total",3333,1885,747,1138,27,1014,685,329,373,328,0,38,7,34
"2011","Plymouth 004","E02003125","Total",2648,1497,681,816,11,855,538,317,247,206,0,34,7,38
"2011","Plymouth 005","E02003126","Total",2909,1897,811,1086,7,675,276,399,291,225,28,19,19,39
"2011","Plymouth 006","E02003127","Total",3060,1760,775,985,41,968,628,340,255,227,4,18,6,36
"2011","Plymouth 007","E02003128","Total",3823,1912,830,1082,62,1305,807,498,489,447,2,35,5,55
"2011","Plymouth 008","E02003129","Total",2760,1777,949,828,5,501,140,361,447,173,168,17,89,30
"2011","Plymouth 009","E02003130","Total",4392,2635,1135,1500,11,1168,422,746,530,466,6,47,11,48
"2011","Plymouth 010","E02003131","Total",3193,2036,855,1181,21,794,306,488,311,265,2,38,6,31
"2011","Plymouth 011","E02003132","Total",3398,2397,1122,1275,19,575,341,234,372,326,7,32,7,35
"2011","Plymouth 012","E02003133","Total",3012,2304,1110,1194,10,420,177,243,251,213,6,24,8,27
"2011","Plymouth 013","E02003134","Total",2735,1351,544,807,18,1107,724,383,216,183,2,25,6,43
"2011","Plymouth 014","E02003135","Total",3008,1412,510,902,5,1099,304,795,466,422,1,27,16,26
"2011","Plymouth 015","E02003136","Total",3286,2787,1549,1238,16,162,45,117,292,266,2,20,4,29
"2011","Plymouth 016","E02003137","Total",3125,2590,1285,1305,2,163,17,146,341,278,17,27,19,29
"2011","Plymouth 017","E02003138","Total",3138,2307,948,1359,16,49,4,45,742,682,5,48,7,24
"2011","Plymouth 018","E02003139","Total",2544,2025,681,1344,57,101,9,92,354,319,2,32,1,7
"2011","Plymouth 019","E02003140","Total",3126,2725,1322,1403,22,82,15,67,277,244,2,30,1,20
"2011","Plymouth 020","E02003141","Total",3690,2050,775,1275,9,321,71,250,1274,1183,3,80,8,36
"2011","Plymouth 021","E02003142","Total",3877,2225,871,1354,56,1006,427,579,551,480,13,50,8,39
"2011","Plymouth 022","E02003143","Total",3295,2311,1039,1272,23,480,117,363,452,293,78,33,48,29
"2011","Plymouth 023","E02003144","Total",3257,1116,515,601,10,36,7,29,2074,2006,8,51,9,21
"2011","Plymouth 024","E02003145","Total",3049,1712,767,945,38,370,149,221,894,829,7,52,6,35
"2011","Plymouth 025","E02003146","Total",3522,1732,682,1050,19,150,63,87,1576,1456,8,105,7,45
"2011","Plymouth 026","E02003147","Total",3579,765,304,461,63,1963,971,992,730,682,3,32,13,58
"2011","Plymouth 027","E02003148","Total",4376,938,491,447,32,1504,601,903,1834,1718,12,70,34,68
"2011","Plymouth 028","E02003149","Total",4158,1542,618,924,71,660,104,556,1822,1698,7,104,13,63
"2011","Plymouth 029","E02003150","Total",6100,1620,755,865,46,1831,563,1268,2531,2380,18,86,47,72
"2011","Plymouth 030","E02003151","Total",3213,2734,1718,1016,7,175,66,109,260,179,32,26,23,37
"2011","Plymouth 031","E02003152","Total",3971,3180,1658,1522,28,209,109,100,503,427,20,39,17,51
"2011","Plymouth 032","E02003153","Total",3379,2534,1352,1182,29,135,25,110,656,376,155,33,92,25
"2011","Poole 001","E02003194","Total",2440,2133,1251,882,6,78,46,32,184,148,20,13,3,39
"2011","Poole 002","E02003195","Total",2176,1633,645,988,13,289,230,59,224,196,1,24,3,17
"2011","Poole 003","E02003196","Total",4197,3880,2278,1602,3,78,66,12,207,185,4,18,0,29
"2011","Poole 004","E02003197","Total",2809,1983,844,1139,23,459,224,235,327,301,0,22,4,17
"2011","Poole 005","E02003198","Total",2898,2126,898,1228,39,276,14,262,437,397,7,30,3,20
"2011","Poole 006","E02003199","Total",3986,3033,1355,1678,21,496,358,138,410,366,3,41,0,26
"2011","Poole 007","E02003200","Total",4139,2635,1238,1397,30,872,646,226,548,489,0,49,10,54
"2011","Poole 008","E02003201","Total",4458,2829,1201,1628,79,784,546,238,708,650,0,51,7,58
"2011","Poole 009","E02003202","Total",2671,1667,770,897,9,407,22,385,571,524,3,37,7,17
"2011","Poole 010","E02003203","Total",3173,2323,922,1401,39,205,81,124,580,537,2,37,4,26
"2011","Poole 011","E02003204","Total",3781,2558,1257,1301,7,506,256,250,671,618,8,38,7,39
"2011","Poole 012","E02003205","Total",3354,2733,1398,1335,27,257,215,42,308,273,7,27,1,29
"2011","Poole 013","E02003206","Total",4077,2992,1406,1586,3,166,35,131,875,830,10,32,3,41
"2011","Poole 014","E02003207","Total",2861,1604,759,845,21,647,474,173,563,377,119,32,35,26
"2011","Poole 015","E02003208","Total",5025,2338,1323,1015,153,1047,582,465,1395,1295,15,66,19,92
"2011","Poole 016","E02003209","Total",2686,1679,814,865,50,495,263,232,432,384,3,39,6,30
"2011","Poole 017","E02003210","Total",4386,3198,1888,1310,23,170,43,127,946,891,4,40,11,49
"2011","Poole 018","E02003211","Total",4413,3358,2472,886,11,92,42,50,889,832,4,47,6,63
"2011","South Gloucestershire 001","E02003090","Total",2802,2279,1280,999,4,182,38,144,301,269,1,28,3,36
"2011","South Gloucestershire 002","E02003091","Total",2756,2092,1081,1011,13,398,68,330,222,184,5,25,8,31
"2011","South Gloucestershire 003","E02003092","Total",2801,2236,1033,1203,18,253,56,197,249,220,9,17,3,45
"2011","South Gloucestershire 004","E02003093","Total",2726,2249,1349,900,10,146,27,119,279,247,2,26,4,42
"2011","South Gloucestershire 005","E02003094","Total",3319,2631,1202,1429,29,239,58,181,387,333,12,33,9,33
"2011","South Gloucestershire 006","E02003095","Total",2723,2261,988,1273,18,135,14,121,289,263,2,21,3,20
"2011","South Gloucestershire 007","E02003096","Total",2719,1987,741,1246,8,251,77,174,453,408,1,44,0,20
"2011","South Gloucestershire 008","E02003097","Total",2681,2119,1155,964,28,241,52,189,267,236,2,29,0,26
"2011","South Gloucestershire 009","E02003098","Total",4145,2863,767,2096,14,35,3,32,1200,1168,0,28,4,33
"2011","South Gloucestershire 010","E02003099","Total",2842,2295,1112,1183,7,207,29,178,310,271,3,31,5,23
"2011","South Gloucestershire 011","E02003100","Total",4514,3177,1410,1767,14,804,180,624,465,427,2,33,3,54
"2011","South Gloucestershire 012","E02003101","Total",4289,2766,704,2062,13,312,6,306,1182,1126,4,46,6,16
"2011","South Gloucestershire 013","E02003102","Total",2577,2133,1120,1013,6,236,60,176,166,150,1,15,0,36
"2011","South Gloucestershire 014","E02003103","Total",2793,2248,782,1466,5,73,7,66,458,413,0,44,1,9
"2011","South Gloucestershire 015","E02003104","Total",3196,2400,1015,1385,17,377,94,283,376,341,4,28,3,26
"2011","South Gloucestershire 016","E02003105","Total",2554,2062,1158,904,11,278,64,214,181,157,0,22,2,22
"2011","South Gloucestershire 017","E02003106","Total",3596,2390,988,1402,36,266,19,247,838,745,22,54,17,66
"2011","South Gloucestershire 018","E02003107","Total",4514,2912,1456,1456,26,611,130,481,909,855,6,40,8,56
"2011","South Gloucestershire 019","E02003108","Total",3813,3047,1414,1633,41,351,55,296,329,284,6,35,4,45
"2011","South Gloucestershire 020","E02003109","Total",2445,2230,1255,975,4,58,17,41,137,129,0,7,1,16
"2011","South Gloucestershire 021","E02003110","Total",3998,3056,1007,2049,4,67,3,64,845,654,101,39,51,26
"2011","South Gloucestershire 022","E02003111","Total",2689,2176,1113,1063,6,201,30,171,278,254,2,22,0,28
"2011","South Gloucestershire 023","E02003112","Total",2635,1615,749,866,17,710,145,565,253,213,2,36,2,40
"2011","South Gloucestershire 024","E02003113","Total",4161,2943,1584,1359,18,444,66,378,615,531,26,44,14,141
"2011","South Gloucestershire 025","E02003114","Total",3133,2314,1225,1089,8,420,75,345,359,330,4,22,3,32
"2011","South Gloucestershire 026","E02003115","Total",3994,2697,1227,1470,23,480,129,351,744,683,5,43,13,50
"2011","South Gloucestershire 027","E02003116","Total",3264,1954,970,984,14,853,175,678,389,351,0,30,8,54
"2011","South Gloucestershire 028","E02003117","Total",3615,2509,1118,1391,25,445,76,369,583,525,7,43,8,53
"2011","South Gloucestershire 029","E02003118","Total",4250,3269,1197,2072,33,389,69,320,538,488,1,47,2,21
"2011","South Gloucestershire 030","E02003119","Total",4163,2945,1239,1706,4,825,182,643,331,289,1,31,10,58
"2011","South Gloucestershire 031","E02003120","Total",3531,2930,1617,1313,12,261,45,216,294,246,1,43,4,34
"2011","South Gloucestershire 032","E02003121","Total",4300,3801,1994,1807,11,85,14,71,373,334,1,33,5,30
"2011","Swindon 001","E02003212","Total",3607,2622,1332,1290,15,535,405,130,386,324,23,25,14,49
"2011","Swindon 003","E02003214","Total",2745,974,445,529,9,1591,1514,77,127,105,1,19,2,44
"2011","Swindon 004","E02003215","Total",3068,2535,1228,1307,7,219,95,124,287,257,2,24,4,20
"2011","Swindon 005","E02003216","Total",3911,2801,1354,1447,13,699,556,143,369,303,19,43,4,29
"2011","Swindon 006","E02003217","Total",2775,1644,626,1018,16,819,716,103,265,242,2,21,0,31
"2011","Swindon 007","E02003218","Total",2596,1356,522,834,1,1020,876,144,168,143,2,20,3,51
"2011","Swindon 008","E02003219","Total",2536,1959,962,997,11,233,188,45,288,242,12,22,12,45
"2011","Swindon 009","E02003220","Total",4321,3492,1592,1900,21,310,159,151,468,421,5,40,2,30
"2011","Swindon 010","E02003221","Total",2872,1692,636,1056,7,513,371,142,634,582,6,39,7,26
"2011","Swindon 011","E02003222","Total",2525,1862,470,1392,21,210,123,87,418,398,0,19,1,14
"2011","Swindon 012","E02003223","Total",4306,2879,988,1891,16,215,97,118,1177,1117,4,51,5,19
"2011","Swindon 013","E02003224","Total",3814,3229,1568,1661,63,173,93,80,329,297,2,29,1,20
"2011","Swindon 014","E02003225","Total",2552,1910,652,1258,24,40,28,12,568,535,2,29,2,10
"2011","Swindon 015","E02003226","Total",3345,1339,438,901,19,610,507,103,1341,1256,5,64,16,36
"2011","Swindon 016","E02003227","Total",2789,833,326,507,124,1587,1358,229,191,173,0,17,1,54
"2011","Swindon 017","E02003228","Total",2698,2004,974,1030,21,161,26,135,485,444,4,31,6,27
"2011","Swindon 018","E02003229","Total",2300,1748,498,1250,56,174,26,148,318,289,0,29,0,4
"2011","Swindon 019","E02003230","Total",3548,1709,594,1115,43,170,31,139,1600,1527,4,61,8,26
"2011","Swindon 020","E02003231","Total",3445,1559,570,989,31,1538,1380,158,267,223,2,35,7,50
"2011","Swindon 021","E02003232","Total",3522,2317,868,1449,185,157,71,86,847,799,4,36,8,16
"2011","Swindon 022","E02003233","Total",3838,2195,803,1392,13,1173,774,399,409,372,1,28,8,48
"2011","Swindon 023","E02003234","Total",3615,2475,1018,1457,10,804,349,455,298,266,0,24,8,28
"2011","Swindon 024","E02003235","Total",3349,2510,1393,1117,79,302,19,283,432,406,7,16,3,26
"2011","Swindon 025","E02003236","Total",4403,3267,1720,1547,54,656,456,200,371,301,23,22,25,55
"2011","Swindon 026","E02006847","Total",3551,2622,397,2225,149,128,15,113,647,620,1,25,1,5
"2011","Swindon 027","E02006848","Total",2892,1721,242,1479,99,210,18,192,853,792,1,58,2,9
"2011","Swindon 028","E02006849","Total",3437,2648,533,2115,11,135,18,117,626,586,3,34,3,17
"2011","Torbay 001","E02003154","Total",3038,1958,977,981,24,692,126,566,340,289,1,44,6,24
"2011","Torbay 002","E02003155","Total",2568,1672,880,792,20,105,8,97,731,673,1,45,12,40
"2011","Torbay 003","E02003156","Total",3944,2698,1173,1525,58,375,32,343,783,705,6,69,3,30
"2011","Torbay 004","E02003157","Total",2819,1483,662,821,58,449,53,396,807,751,1,47,8,22
"2011","Torbay 005","E02003158","Total",2529,1724,985,739,8,177,21,156,579,527,3,44,5,41
"2011","Torbay 006","E02003159","Total",2449,1597,632,965,10,84,4,80,747,681,3,61,2,11
"2011","Torbay 008","E02003161","Total",3553,1275,634,641,46,324,13,311,1851,1778,11,52,10,57
"2011","Torbay 010","E02003163","Total",4109,2597,1684,913,25,139,4,135,1308,1249,6,45,8,40
"2011","Torbay 011","E02003164","Total",3821,3137,1788,1349,13,76,7,69,549,498,3,45,3,46
"2011","Torbay 012","E02003165","Total",3038,2446,1242,1204,14,66,10,56,494,448,1,43,2,18
"2011","Torbay 013","E02003166","Total",4349,2749,1349,1400,105,844,103,741,621,572,2,41,6,30
"2011","Torbay 014","E02003167","Total",4448,2189,1298,891,16,361,35,326,1838,1736,4,86,12,44
"2011","Torbay 015","E02003168","Total",3081,2332,1268,1064,74,200,13,187,453,393,7,49,4,22
"2011","Torbay 016","E02003169","Total",3027,2624,1779,845,5,100,6,94,265,232,4,27,2,33
"2011","Torbay 017","E02003170","Total",4500,3199,2056,1143,36,264,17,247,957,866,7,76,8,44
"2011","Torbay 018","E02003171","Total",3236,2377,1348,1029,30,282,31,251,508,447,2,53,6,39
"2011","Torbay 019","E02006840","Total",4501,3367,1748,1619,12,224,22,202,865,802,3,52,8,33
"2011","Wiltshire 012","E02006634","Total",3533,2367,1329,1038,22,481,43,438,487,397,45,31,14,176
"2011","Wiltshire 019","E02006635","Total",3415,2055,1205,850,15,733,97,636,496,411,51,25,9,116
"2011","Wiltshire 024","E02006636","Total",3059,2006,1124,882,38,536,72,464,387,327,24,21,15,92
"2011","Wiltshire 025","E02006637","Total",4505,2857,1245,1612,118,868,84,784,627,526,27,47,27,35
"2011","Wiltshire 026","E02006638","Total",3076,1741,1036,705,14,940,91,849,348,315,13,13,7,33
"2011","Wiltshire 028","E02006639","Total",3391,2396,1316,1080,24,588,76,512,327,266,16,30,15,56
"2011","Wiltshire 029","E02006640","Total",2941,1968,1034,934,43,408,44,364,426,344,30,20,32,96
"2011","Wiltshire 034","E02006641","Total",2968,2104,1063,1041,15,443,40,403,338,270,19,30,19,68
"2011","Wiltshire 038","E02006642","Total",2412,1562,789,773,12,380,45,335,418,248,92,13,65,40
"2011","Wiltshire 041","E02006643","Total",4512,1653,573,1080,56,1079,152,927,1698,598,650,26,424,26
"2011","Wiltshire 001","E02006644","Total",2782,2143,1076,1067,20,305,44,261,269,243,6,16,4,45
"2011","Wiltshire 002","E02006645","Total",2992,2043,983,1060,27,415,41,374,468,429,12,16,11,39
"2011","Wiltshire 003","E02006646","Total",2242,1800,938,862,7,229,22,207,180,151,5,19,5,26
"2011","Wiltshire 004","E02006647","Total",2337,1912,1052,860,9,124,13,111,248,217,6,20,5,44
"2011","Wiltshire 005","E02006648","Total",2398,1707,964,743,14,221,22,199,410,282,51,11,66,46
"2011","Wiltshire 006","E02006649","Total",2979,1988,962,1026,29,529,57,472,405,368,9,24,4,28
"2011","Wiltshire 007","E02006650","Total",4387,3103,1579,1524,16,277,27,250,940,365,340,26,209,51
"2011","Wiltshire 008","E02006651","Total",2760,2123,1102,1021,12,216,22,194,335,254,45,18,18,74
"2011","Wiltshire 009","E02006652","Total",3703,2772,1152,1620,10,451,42,409,441,412,4,21,4,29
"2011","Wiltshire 010","E02006653","Total",3989,2987,1278,1709,25,505,47,458,434,396,5,29,4,38
"2011","Wiltshire 011","E02006654","Total",4291,2451,1256,1195,63,1141,94,1047,586,537,7,36,6,50
"2011","Wiltshire 013","E02006655","Total",2703,2057,1040,1017,8,189,22,167,384,349,15,15,5,65
"2011","Wiltshire 014","E02006656","Total",2867,2179,725,1454,24,209,23,186,442,411,1,26,4,13
"2011","Wiltshire 015","E02006657","Total",3951,2519,838,1681,61,787,103,684,516,466,8,28,14,68
"2011","Wiltshire 016","E02006658","Total",3162,2401,1118,1283,16,363,31,332,350,308,6,30,6,32
"2011","Wiltshire 017","E02006659","Total",2997,2065,1045,1020,12,307,32,275,575,252,194,26,103,38
"2011","Wiltshire 018","E02006660","Total",5481,3619,1791,1828,58,939,107,832,779,654,46,45,34,86
"2011","Wiltshire 045","E02006661","Total",2808,1082,504,578,19,334,176,158,1342,256,620,5,461,31
"2011","Wiltshire 046","E02006662","Total",2367,1581,705,876,12,419,318,101,333,214,60,11,48,22
"2011","Wiltshire 048","E02006663","Total",4264,2552,1056,1496,93,861,458,403,723,517,112,30,64,35
"2011","Wiltshire 049","E02006664","Total",2683,1920,1113,807,12,262,237,25,420,300,68,14,38,69
"2011","Wiltshire 050","E02006665","Total",2953,1970,1244,726,26,425,315,110,445,385,26,19,15,87
"2011","Wiltshire 051","E02006666","Total",2338,1676,837,839,15,404,299,105,213,185,1,26,1,30
"2011","Wiltshire 052","E02006667","Total",2509,1120,465,655,24,1110,869,241,222,174,3,30,15,33
"2011","Wiltshire 053","E02006668","Total",2517,1822,961,861,9,447,360,87,214,182,7,18,7,25
"2011","Wiltshire 054","E02006669","Total",4358,2640,1524,1116,32,698,516,182,870,689,106,27,48,118
"2011","Wiltshire 055","E02006670","Total",3068,1824,824,1000,33,330,112,218,830,758,5,56,11,51
"2011","Wiltshire 056","E02006671","Total",2791,1588,841,747,22,298,203,95,834,760,14,46,14,49
"2011","Wiltshire 057","E02006672","Total",2728,1918,1077,841,39,319,129,190,377,266,72,18,21,75
"2011","Wiltshire 058","E02006673","Total",2435,1474,943,531,12,484,287,197,402,355,15,18,14,63
"2011","Wiltshire 059","E02006674","Total",2425,1410,716,694,42,563,295,268,379,316,30,15,18,31
"2011","Wiltshire 060","E02006675","Total",3229,2626,1444,1182,15,208,145,63,323,279,14,24,6,57
"2011","Wiltshire 061","E02006676","Total",2658,1750,1127,623,15,406,333,73,397,351,17,23,6,90
"2011","Wiltshire 062","E02006677","Total",3201,2476,1456,1020,20,249,211,38,383,336,14,24,9,73
"2011","Wiltshire 020","E02006678","Total",3033,2249,1018,1231,4,432,49,383,325,290,1,30,4,23
"2011","Wiltshire 021","E02006679","Total",3872,3025,1446,1579,19,407,33,374,377,323,17,33,4,44
"2011","Wiltshire 022","E02006680","Total",3251,2136,1024,1112,23,570,83,487,485,448,4,32,1,37
"2011","Wiltshire 023","E02006681","Total",2538,2021,1206,815,4,244,30,214,230,203,3,16,8,39
"2011","Wiltshire 027","E02006682","Total",4286,3164,1877,1287,13,590,74,516,471,438,3,25,5,48
"2011","Wiltshire 030","E02006683","Total",3094,2385,980,1405,7,344,35,309,331,300,10,17,4,27
"2011","Wiltshire 031","E02006684","Total",2778,1588,741,847,15,462,67,395,687,649,4,29,5,26
"2011","Wiltshire 032","E02006685","Total",3234,2377,1148,1229,19,296,23,273,516,466,19,21,10,26
"2011","Wiltshire 033","E02006686","Total",2130,1452,738,714,8,499,57,442,157,134,3,15,5,14
"2011","Wiltshire 035","E02006687","Total",3017,1926,811,1115,25,598,78,520,453,417,5,30,1,15
"2011","Wiltshire 036","E02006688","Total",2447,1799,770,1029,14,194,28,166,417,378,4,30,5,23
"2011","Wiltshire 037","E02006689","Total",2584,2165,1198,967,3,124,21,103,273,237,12,16,8,19
"2011","Wiltshire 039","E02006690","Total",2865,2296,1217,1079,9,236,29,207,288,243,12,30,3,36
"2011","Wiltshire 040","E02006691","Total",5595,3704,1424,2280,30,870,90,780,933,846,12,63,12,58
"2011","Wiltshire 042","E02006692","Total",2290,1302,768,534,9,333,41,292,621,190,227,19,185,25
"2011","Wiltshire 043","E02006693","Total",2462,1783,811,972,26,327,55,272,304,265,6,26,7,22
"2011","Wiltshire 044","E02006694","Total",2791,1842,1027,815,14,344,36,308,546,497,9,33,7,45
"2011","Wiltshire 047","E02006695","Total",2762,1862,1080,782,13,241,19,222,533,460,33,19,21,113
"2011","East Devon 001","E02004129","Total",2363,1916,1238,678,17,102,63,39,275,222,9,40,4,53
"2011","East Devon 002","E02004130","Total",2873,1828,1135,693,7,498,354,144,491,457,4,28,2,49
"2011","East Devon 003","E02004131","Total",2421,1930,1050,880,11,172,110,62,291,267,0,21,3,17
"2011","East Devon 004","E02004132","Total",3349,2653,1488,1165,14,204,147,57,414,362,9,38,5,64
"2011","East Devon 005","E02004133","Total",3711,2646,1702,944,24,493,343,150,490,418,10,57,5,58
"2011","East Devon 006","E02004134","Total",2810,2021,1089,932,16,283,204,79,434,363,17,33,21,56
"2011","East Devon 007","E02004135","Total",3604,2865,2020,845,11,319,238,81,344,294,7,38,5,65
"2011","East Devon 008","E02004136","Total",3398,2704,1647,1057,24,250,194,56,383,342,8,30,3,37
"2011","East Devon 009","E02004137","Total",2375,1862,1344,518,15,188,150,38,264,221,13,25,5,46
"2011","East Devon 010","E02004138","Total",3564,2744,1993,751,16,252,159,93,513,469,8,34,2,39
"2011","East Devon 011","E02004139","Total",3032,2245,1536,709,44,480,364,116,224,196,1,24,3,39
"2011","East Devon 012","E02004140","Total",2606,2108,1668,440,4,115,67,48,326,293,7,20,6,53
"2011","East Devon 013","E02004141","Total",2472,1843,1110,733,6,205,174,31,359,324,14,14,7,59
"2011","East Devon 014","E02004142","Total",2224,1720,1078,642,17,103,84,19,344,244,38,24,38,40
"2011","East Devon 015","E02004143","Total",2679,2247,1190,1057,11,185,131,54,209,178,10,12,9,27
"2011","East Devon 016","E02004144","Total",2973,2457,1393,1064,6,165,50,115,319,252,28,29,10,26
"2011","East Devon 017","E02004145","Total",2896,2253,1658,595,21,230,179,51,344,307,5,24,8,48
"2011","East Devon 018","E02004146","Total",3043,2037,967,1070,28,646,437,209,311,259,11,31,10,21
"2011","East Devon 019","E02004147","Total",3328,1862,917,945,17,147,36,111,1238,1133,13,84,8,64
"2011","East Devon 020","E02004148","Total",3350,2342,1614,728,10,478,431,47,468,433,3,25,7,52
"2011","Exeter 001","E02004149","Total",2681,2083,1238,845,35,150,47,103,388,364,6,14,4,25
"2011","Exeter 002","E02004150","Total",2835,1512,663,849,9,755,660,95,536,496,2,32,6,23
"2011","Exeter 003","E02004151","Total",3284,2400,1310,1090,33,549,248,301,267,236,6,20,5,35
"2011","Exeter 004","E02004152","Total",2986,1090,598,492,24,244,46,198,1602,1537,6,50,9,26
"2011","Exeter 005","E02004153","Total",3219,1936,737,1199,62,682,117,565,515,469,2,39,5,24
"2011","Exeter 006","E02004154","Total",3183,1801,787,1014,26,325,69,256,1004,945,2,55,2,27
"2011","Exeter 007","E02004155","Total",3305,1949,1003,946,12,1023,979,44,252,221,3,26,2,69
"2011","Exeter 008","E02004156","Total",4766,1335,694,641,78,1481,538,943,1765,1697,8,52,8,107
"2011","Exeter 009","E02004157","Total",2993,1801,961,840,15,284,116,168,857,821,0,27,9,36
"2011","Exeter 010","E02004158","Total",3317,2188,911,1277,22,379,170,209,685,615,4,58,8,43
"2011","Exeter 011","E02004159","Total",3939,2983,1371,1612,59,270,106,164,601,564,4,31,2,26
"2011","Exeter 012","E02004160","Total",3030,2356,1286,1070,8,416,237,179,228,197,3,25,3,22
"2011","Exeter 013","E02004161","Total",3313,1691,760,931,41,1104,985,119,420,341,29,34,16,57
"2011","Exeter 014","E02004162","Total",3247,2068,1018,1050,27,335,141,194,795,748,2,44,1,22
"2011","Exeter 015","E02004163","Total",3144,2250,1472,778,19,389,310,79,421,382,10,27,2,65
"2011","Mid Devon 001","E02004164","Total",2747,2094,1286,808,13,169,145,24,407,357,7,36,7,64
"2011","Mid Devon 002","E02004165","Total",3433,2667,1533,1134,27,78,6,72,624,572,10,33,9,37
"2011","Mid Devon 003","E02004166","Total",2715,1920,1073,847,42,356,192,164,333,296,7,28,2,64
"2011","Mid Devon 004","E02004167","Total",3015,1445,646,799,79,891,693,198,527,489,6,30,2,73
"2011","Mid Devon 005","E02004168","Total",2734,1359,666,693,10,682,465,217,623,562,23,26,12,60
"2011","Mid Devon 006","E02004169","Total",2858,2193,1133,1060,18,268,196,72,327,293,7,24,3,52
"2011","Mid Devon 007","E02004170","Total",3223,2202,1013,1189,31,470,277,193,478,436,6,31,5,42
"2011","Mid Devon 008","E02004171","Total",3144,2324,1306,1018,10,306,241,65,443,408,7,23,5,61
"2011","Mid Devon 009","E02004172","Total",2571,1999,1164,835,15,195,167,28,315,277,8,29,1,47
"2011","Mid Devon 010","E02004173","Total",2922,2195,1217,978,16,238,211,27,413,358,19,33,3,60
"2011","Mid Devon 011","E02004174","Total",3396,2228,1169,1059,44,482,250,232,601,557,8,31,5,41
"2011","North Devon 001","E02004175","Total",2491,1307,673,634,10,266,48,218,870,820,4,37,9,38
"2011","North Devon 002","E02004176","Total",2421,1797,1176,621,6,129,22,107,427,375,6,38,8,62
"2011","North Devon 003","E02004177","Total",2541,1675,880,795,9,267,45,222,555,521,4,28,2,35
"2011","North Devon 004","E02004178","Total",2260,1796,1118,678,7,71,15,56,332,269,23,33,7,54
"2011","North Devon 005","E02004179","Total",3717,2580,1553,1027,31,347,65,282,702,450,116,41,95,57
"2011","North Devon 006","E02004180","Total",2273,1818,1074,744,12,90,22,68,308,251,16,31,10,45
"2011","North Devon 007","E02004181","Total",2571,1690,874,816,34,405,74,331,408,334,25,37,12,34
"2011","North Devon 008","E02004182","Total",2896,1306,597,709,10,793,180,613,751,697,9,33,12,36
"2011","North Devon 009","E02004183","Total",2654,1904,1187,717,8,238,54,184,465,411,13,34,7,39
"2011","North Devon 010","E02004184","Total",3532,2166,916,1250,15,650,215,435,673,628,1,40,4,28
"2011","North Devon 011","E02004185","Total",2510,2070,1302,768,24,138,36,102,255,225,5,18,7,23
"2011","North Devon 012","E02004186","Total",3426,2568,1382,1186,38,256,53,203,522,465,6,43,8,42
"2011","North Devon 013","E02004187","Total",3966,2610,1552,1058,52,412,91,321,763,669,22,65,7,129
"2011","North Devon 014","E02004188","Total",2743,2096,1354,742,15,254,51,203,310,262,11,30,7,68
"2011","South Hams 001","E02004189","Total",2417,1791,716,1075,18,131,24,107,446,405,5,33,3,31
"2011","South Hams 002","E02004190","Total",3285,2381,1411,970,34,348,52,296,460,407,8,37,8,62
"2011","South Hams 003","E02004191","Total",3848,2239,1389,850,57,793,94,699,706,653,1,48,4,53
"2011","South Hams 004","E02004192","Total",3230,2616,1691,925,10,128,20,108,399,347,9,35,8,77
"2011","South Hams 005","E02004193","Total",4741,3731,1652,2079,57,390,55,335,517,463,6,42,6,46
"2011","South Hams 006","E02004194","Total",2655,1879,1155,724,36,251,29,222,444,384,11,43,6,45
"2011","South Hams 007","E02004195","Total",2635,1563,967,596,25,570,111,459,436,357,32,25,22,41
"2011","South Hams 008","E02004196","Total",3111,2252,1418,834,26,324,49,275,453,407,4,34,8,56
"2011","South Hams 009","E02004197","Total",2874,2270,1475,795,63,223,34,189,292,251,11,21,9,26
"2011","South Hams 010","E02004198","Total",2980,1835,1115,720,37,555,103,452,508,450,7,44,7,45
"2011","South Hams 011","E02004199","Total",2550,1994,1449,545,17,195,35,160,301,269,5,24,3,43
"2011","South Hams 012","E02004200","Total",2532,1889,1337,552,20,287,36,251,297,245,7,38,7,39
"2011","Teignbridge 001","E02004201","Total",2231,1804,1225,579,12,100,44,56,284,257,8,15,4,31
"2011","Teignbridge 002","E02004202","Total",3332,2459,1262,1197,15,275,61,214,533,497,10,21,5,50
"2011","Teignbridge 003","E02004203","Total",2425,1875,1187,688,12,183,42,141,305,254,13,34,4,50
"2011","Teignbridge 004","E02004204","Total",4038,3046,1617,1429,26,345,77,268,571,510,7,43,11,50
"2011","Teignbridge 005","E02004205","Total",2759,2151,1234,917,34,109,21,88,432,382,8,39,3,33
"2011","Teignbridge 006","E02004206","Total",3216,2015,1292,723,59,375,74,301,700,645,3,45,7,67
"2011","Teignbridge 007","E02004207","Total",2534,2019,1128,891,22,193,46,147,277,256,1,20,0,23
"2011","Teignbridge 008","E02004208","Total",3423,2896,1659,1237,19,64,6,58,414,371,1,38,4,30
"2011","Teignbridge 009","E02004209","Total",3553,2677,1288,1389,22,363,60,303,455,399,5,47,4,36
"2011","Teignbridge 010","E02004210","Total",3268,1761,999,762,36,540,133,407,870,806,6,50,8,61
"2011","Teignbridge 011","E02004211","Total",2946,2467,1550,917,27,64,15,49,357,316,4,35,2,31
"2011","Teignbridge 012","E02004212","Total",2494,1851,888,963,42,274,66,208,307,274,1,30,2,20
"2011","Teignbridge 013","E02004213","Total",2049,1660,847,813,20,23,8,15,333,301,3,25,4,13
"2011","Teignbridge 014","E02004214","Total",2821,1498,622,876,41,484,125,359,763,688,6,64,5,35
"2011","Teignbridge 015","E02004215","Total",2390,1560,765,795,9,381,59,322,410,380,5,18,7,30
"2011","Teignbridge 016","E02004216","Total",2383,1874,1030,844,13,271,100,171,210,183,2,20,5,15
"2011","Teignbridge 017","E02004217","Total",3382,2168,1197,971,41,503,145,358,626,553,16,47,10,44
"2011","Teignbridge 018","E02004218","Total",2462,2006,1122,884,30,139,45,94,264,230,4,27,3,23
"2011","Teignbridge 019","E02004219","Total",2297,1891,1103,788,15,127,42,85,247,224,4,18,1,17
"2011","Torridge 001","E02004220","Total",3027,2118,1321,797,30,336,85,251,495,445,2,47,1,48
"2011","Torridge 002","E02004221","Total",2767,2207,1504,703,12,63,6,57,456,423,4,27,2,29
"2011","Torridge 003","E02004222","Total",2762,1650,900,750,5,277,27,250,775,722,2,44,7,55
"2011","Torridge 004","E02004223","Total",4793,3089,1522,1567,78,876,222,654,688,627,6,47,8,62
"2011","Torridge 005","E02004224","Total",2640,1905,1183,722,14,142,29,113,502,432,17,46,7,77
"2011","Torridge 006","E02004225","Total",2438,1621,862,759,5,306,55,251,477,433,4,35,5,29
"2011","Torridge 007","E02004226","Total",3047,2410,1538,872,21,142,30,112,403,356,13,33,1,71
"2011","Torridge 008","E02004227","Total",3682,2738,1730,1008,19,261,59,202,585,520,13,47,5,79
"2011","Torridge 009","E02004228","Total",2830,2260,1438,822,13,121,29,92,365,317,8,37,3,71
"2011","West Devon 001","E02004229","Total",3272,2484,1548,936,25,219,51,168,490,422,11,53,4,54
"2011","West Devon 002","E02004230","Total",3242,2152,1194,958,23,413,89,324,618,571,3,37,7,36
"2011","West Devon 003","E02004231","Total",2710,1906,1194,712,15,254,81,173,468,406,9,34,19,67
"2011","West Devon 004","E02004232","Total",2639,2005,1217,788,8,135,54,81,429,385,14,27,3,62
"2011","West Devon 005","E02004233","Total",5467,3847,2269,1578,51,641,177,464,836,776,6,49,5,92
"2011","West Devon 006","E02004234","Total",2630,2133,1333,800,10,221,64,157,233,195,2,30,6,33
"2011","West Devon 007","E02004235","Total",2765,2103,1248,855,16,275,66,209,335,270,19,34,12,36
"2011","Christchurch 001","E02004236","Total",2440,1910,1026,884,22,249,13,236,233,209,3,18,3,26
"2011","Christchurch 002","E02004237","Total",3105,2462,1350,1112,20,363,20,343,231,208,1,20,2,29
"2011","Christchurch 003","E02004238","Total",3503,2792,2025,767,23,281,43,238,375,331,6,35,3,32
"2011","Christchurch 004","E02004239","Total",2627,2329,1527,802,21,41,2,39,202,180,3,18,1,34
"2011","Christchurch 005","E02004240","Total",2576,1233,577,656,33,1088,74,1014,199,178,1,18,2,23
"2011","Christchurch 006","E02004241","Total",4132,2671,1512,1159,48,603,41,562,755,699,10,42,4,55
"2011","Christchurch 007","E02004242","Total",3092,2570,1797,773,15,159,7,152,326,310,1,13,2,22
"2011","East Dorset 001","E02004243","Total",2605,1867,981,886,5,268,22,246,374,321,20,19,14,91
"2011","East Dorset 002","E02004244","Total",3096,2765,1419,1346,10,41,7,34,254,220,0,30,4,26
"2011","East Dorset 003","E02004245","Total",2965,2316,1164,1152,7,411,50,361,202,180,2,18,2,29
"2011","East Dorset 004","E02004246","Total",3040,2787,1920,867,4,57,2,55,161,137,6,12,6,31
"2011","East Dorset 005","E02004247","Total",2373,1617,931,686,3,223,9,214,425,361,22,17,25,105
"2011","East Dorset 006","E02004248","Total",3492,2880,1966,914,11,320,34,286,254,183,33,15,23,27
"2011","East Dorset 007","E02004249","Total",2223,1949,1106,843,4,152,11,141,106,97,1,7,1,12
"2011","East Dorset 008","E02004250","Total",3569,2689,1838,851,21,492,47,445,341,303,4,23,11,26
"2011","East Dorset 009","E02004251","Total",2757,2403,1340,1063,10,132,10,122,192,174,4,14,0,20
"2011","East Dorset 010","E02004252","Total",3422,2088,1301,787,23,702,56,646,551,512,7,23,9,58
"2011","East Dorset 011","E02004253","Total",3944,3575,2268,1307,6,62,8,54,268,239,8,18,3,33
"2011","East Dorset 012","E02004254","Total",4078,3435,1783,1652,7,260,36,224,343,301,5,32,5,33
"2011","North Dorset 001","E02004255","Total",3399,2411,1333,1078,22,452,35,417,482,442,3,33,4,32
"2011","North Dorset 002","E02004256","Total",3769,2930,1612,1318,61,252,17,235,461,408,16,29,8,65
"2011","North Dorset 003","E02004257","Total",3235,2214,1180,1034,22,491,30,461,468,426,4,34,4,40
"2011","North Dorset 004","E02004258","Total",4545,3242,2004,1238,39,670,45,625,535,471,20,37,7,59
"2011","North Dorset 005","E02004259","Total",2759,2033,1288,745,12,372,31,341,283,218,20,27,18,59
"2011","North Dorset 006","E02004260","Total",3328,1964,1128,836,17,379,28,351,858,382,303,27,146,110
"2011","North Dorset 007","E02004261","Total",4438,2888,1324,1564,30,830,64,766,647,593,10,32,12,43
"2011","North Dorset 008","E02004262","Total",3197,2320,1417,903,14,419,32,387,360,307,14,27,12,84
"2011","Purbeck 001","E02004263","Total",2463,1707,938,769,12,355,79,276,333,296,9,18,10,56
"2011","Purbeck 002","E02004264","Total",3372,2595,1352,1243,49,263,60,203,428,381,6,37,4,37
"2011","Purbeck 003","E02004265","Total",3690,2589,1619,970,21,556,96,460,478,425,19,30,4,46
"2011","Purbeck 004","E02004266","Total",3313,1905,1086,819,33,531,95,436,758,402,223,25,108,86
"2011","Purbeck 005","E02004267","Total",2241,1585,1109,476,25,225,32,193,340,287,22,15,16,66
"2011","Purbeck 006","E02004268","Total",4504,3232,2202,1030,25,516,82,434,668,600,8,55,5,63
"2011","West Dorset 001","E02004269","Total",4213,2585,1747,838,23,783,41,742,704,646,22,26,10,118
"2011","West Dorset 002","E02004270","Total",3226,2372,1581,791,21,297,17,280,442,390,24,17,11,94
"2011","West Dorset 003","E02004271","Total",4408,3060,2069,991,21,558,37,521,650,573,30,41,6,119
"2011","West Dorset 004","E02004272","Total",4925,3488,2034,1454,55,544,37,507,699,608,45,37,9,139
"2011","West Dorset 005","E02004273","Total",3338,2417,1731,686,29,465,18,447,356,307,8,27,14,71
"2011","West Dorset 006","E02004274","Total",3001,2053,1295,758,15,549,34,515,342,305,3,31,3,42
"2011","West Dorset 007","E02004275","Total",3366,2575,1842,733,30,268,18,250,428,358,18,39,13,65
"2011","West Dorset 008","E02004276","Total",2813,1861,1317,544,31,479,20,459,410,371,7,25,7,32
"2011","West Dorset 009","E02004277","Total",4573,2691,1492,1199,63,976,47,929,778,722,6,42,8,65
"2011","West Dorset 010","E02004278","Total",3876,2840,1616,1224,25,535,18,517,437,397,6,28,6,39
"2011","West Dorset 011","E02004279","Total",3323,2477,1446,1031,35,341,25,316,378,323,27,23,5,92
"2011","West Dorset 012","E02004280","Total",3324,2404,1393,1011,22,364,55,309,469,419,15,33,2,65
"2011","Weymouth and Portland 001","E02004281","Total",3176,1885,832,1053,29,779,293,486,445,404,4,36,1,38
"2011","Weymouth and Portland 002","E02004282","Total",3912,3297,2140,1157,16,127,32,95,427,382,6,33,6,45
"2011","Weymouth and Portland 003","E02004283","Total",3709,2713,1541,1172,19,583,197,386,344,297,5,39,3,50
"2011","Weymouth and Portland 004","E02004284","Total",4743,2276,1417,859,32,519,142,377,1822,1702,14,84,22,94
"2011","Weymouth and Portland 005","E02004285","Total",3299,2098,994,1104,16,570,199,371,574,535,1,36,2,41
"2011","Weymouth and Portland 006","E02004286","Total",2122,1497,751,746,9,313,105,208,281,258,2,20,1,22
"2011","Weymouth and Portland 007","E02004287","Total",2399,1771,946,825,8,300,88,212,304,271,2,26,5,16
"2011","Weymouth and Portland 008","E02004288","Total",2094,1177,618,559,8,468,160,308,427,393,3,25,6,14
"2011","Weymouth and Portland 009","E02004289","Total",3081,2347,1182,1165,24,235,77,158,449,409,1,28,11,26
"2011","Cheltenham 001","E02004600","Total",2451,1799,851,948,9,247,204,43,368,335,4,26,3,28
"2011","Cheltenham 002","E02004601","Total",2341,2017,1233,784,1,113,74,39,185,162,2,19,2,25
"2011","Cheltenham 003","E02004602","Total",2771,1488,572,916,50,825,465,360,384,356,3,17,8,24
"2011","Cheltenham 004","E02004603","Total",2958,1208,579,629,18,531,292,239,1179,1115,4,51,9,22
"2011","Cheltenham 005","E02004604","Total",3437,1367,551,816,67,1576,1256,320,385,339,1,40,5,42
"2011","Cheltenham 006","E02004605","Total",2443,1273,573,700,10,844,739,105,264,244,1,15,4,52
"2011","Cheltenham 007","E02004606","Total",4147,2463,1018,1445,23,513,391,122,1109,1033,3,64,9,39
"2011","Cheltenham 008","E02004607","Total",4794,2575,1128,1447,41,315,115,200,1810,1740,3,59,8,53
"2011","Cheltenham 009","E02004608","Total",5072,2200,1158,1042,20,358,51,307,2430,2330,16,73,11,64
"2011","Cheltenham 010","E02004609","Total",3125,2512,1252,1260,40,114,63,51,435,395,2,33,5,24
"2011","Cheltenham 011","E02004610","Total",3618,2613,1476,1137,9,134,37,97,801,760,4,34,3,61
"2011","Cheltenham 012","E02004611","Total",4586,3703,1801,1902,29,262,182,80,552,497,1,46,8,40
"2011","Cheltenham 013","E02004612","Total",4155,3391,1725,1666,38,242,173,69,462,422,3,35,2,22
"2011","Cheltenham 014","E02004613","Total",2755,2328,1361,967,1,98,5,93,306,295,3,7,1,22
"2011","Cheltenham 015","E02004614","Total",2276,1942,1085,857,4,55,44,11,255,237,1,15,2,20
"2011","Cotswold 001","E02004615","Total",3589,2512,1578,934,62,518,53,465,401,353,19,20,9,96
"2011","Cotswold 002","E02004616","Total",4055,2590,1613,977,48,653,70,583,620,525,48,33,14,144
"2011","Cotswold 003","E02004617","Total",3428,2339,1370,969,59,419,31,388,496,429,26,31,10,115
"2011","Cotswold 004","E02004618","Total",2990,1984,1148,836,4,204,27,177,600,527,36,27,10,198
"2011","Cotswold 005","E02004619","Total",3171,2019,1182,837,11,376,53,323,598,516,26,27,29,167
"2011","Cotswold 006","E02004620","Total",3149,2353,1153,1200,24,479,59,420,261,231,2,22,6,32
"2011","Cotswold 007","E02004621","Total",3103,1568,963,605,16,785,81,704,676,616,16,33,11,58
"2011","Cotswold 008","E02004622","Total",2798,1645,859,786,36,572,73,499,522,390,66,20,46,23
"2011","Cotswold 009","E02004623","Total",3451,2478,1448,1030,47,479,71,408,365,318,16,24,7,82
"2011","Cotswold 010","E02004624","Total",2488,1707,903,804,78,305,25,280,366,326,14,22,4,32
"2011","Cotswold 011","E02004625","Total",4014,2608,1474,1134,56,598,80,518,613,536,36,30,11,139
"2011","Forest of Dean 001","E02004626","Total",3645,2931,1768,1163,28,234,47,187,383,329,11,35,8,69
"2011","Forest of Dean 002","E02004627","Total",2302,1605,925,680,13,298,58,240,348,310,4,32,2,38
"2011","Forest of Dean 003","E02004628","Total",3201,2444,1291,1153,40,438,81,357,237,195,4,32,6,42
"2011","Forest of Dean 004","E02004629","Total",5333,3666,1928,1738,16,906,180,726,673,615,6,42,10,72
"2011","Forest of Dean 005","E02004630","Total",2605,2065,1185,880,15,164,39,125,306,262,10,29,5,55
"2011","Forest of Dean 006","E02004631","Total",2130,1797,1024,773,2,120,24,96,183,148,4,27,4,28
"2011","Forest of Dean 007","E02004632","Total",4362,3011,1558,1453,7,759,133,626,516,469,3,34,10,69
"2011","Forest of Dean 008","E02004633","Total",3423,2626,1425,1201,34,439,52,387,276,240,1,29,6,48
"2011","Forest of Dean 009","E02004634","Total",4263,3021,1585,1436,20,644,112,532,506,449,4,48,5,72
"2011","Forest of Dean 010","E02004635","Total",2903,2205,1277,928,11,235,47,188,407,244,80,18,65,45
"2011","Gloucester 001","E02004636","Total",3272,2858,1409,1449,9,55,30,25,322,286,1,34,1,28
"2011","Gloucester 002","E02004637","Total",3965,2142,1134,1008,46,548,257,291,1184,1124,5,44,11,45
"2011","Gloucester 003","E02004638","Total",2285,1936,915,1021,7,128,98,30,206,191,1,11,3,8
"2011","Gloucester 004","E02004639","Total",3935,1613,751,862,79,702,301,401,1489,1399,22,50,18,52
"2011","Gloucester 005","E02004640","Total",2987,1564,734,830,12,429,133,296,928,868,5,46,9,54
"2011","Gloucester 006","E02004641","Total",3260,2766,1643,1123,14,159,103,56,295,261,2,29,3,26
"2011","Gloucester 007","E02004642","Total",4580,3434,1332,2102,59,560,333,227,502,441,3,52,6,25
"2011","Gloucester 008","E02004643","Total",3000,1541,554,987,24,739,395,344,659,623,2,29,5,37
"2011","Gloucester 009","E02004644","Total",3547,2218,862,1356,13,707,462,245,578,527,6,39,6,31
"2011","Gloucester 010","E02004645","Total",3941,3274,1244,2030,25,116,48,68,499,454,0,40,5,27
"2011","Gloucester 011","E02004646","Total",3782,2077,935,1142,18,1330,1175,155,299,266,0,29,4,58
"2011","Gloucester 012","E02004647","Total",2423,1616,813,803,30,585,453,132,161,138,4,17,2,31
"2011","Gloucester 013","E02004648","Total",2549,2094,1121,973,18,119,84,35,301,268,3,26,4,17
"2011","Gloucester 014","E02004649","Total",2812,2115,515,1600,26,107,7,100,549,496,2,47,4,15
"2011","Gloucester 015","E02004650","Total",4025,2610,767,1843,177,430,42,388,783,670,51,32,30,25
"2011","Stroud 001","E02004651","Total",3173,2398,1031,1367,45,179,113,66,529,486,14,23,6,22
"2011","Stroud 002","E02004652","Total",2828,2247,1498,749,14,152,120,32,365,326,13,16,10,50
"2011","Stroud 003","E02004653","Total",2569,1981,1032,949,26,248,200,48,270,233,11,20,6,44
"2011","Stroud 004","E02004654","Total",4731,3305,1701,1604,13,813,673,140,548,505,6,36,1,52
"2011","Stroud 005","E02004655","Total",3193,2143,973,1170,12,590,525,65,393,365,3,23,2,55
"2011","Stroud 006","E02004656","Total",4967,3117,1500,1617,38,851,541,310,892,832,4,51,5,69
"2011","Stroud 007","E02004657","Total",2860,2379,1159,1220,9,142,83,59,311,287,0,21,3,19
"2011","Stroud 008","E02004658","Total",2681,2218,1054,1164,5,108,92,16,325,300,1,20,4,25
"2011","Stroud 009","E02004659","Total",2640,2034,1167,867,10,355,324,31,192,168,4,16,4,49
"2011","Stroud 010","E02004660","Total",2760,2189,1380,809,6,303,252,51,222,200,3,14,5,40
"2011","Stroud 011","E02004661","Total",3573,2688,1408,1280,23,599,529,70,220,191,5,23,1,43
"2011","Stroud 012","E02004662","Total",2540,1814,989,825,14,298,258,40,375,335,8,22,10,39
"2011","Stroud 013","E02004663","Total",2827,1936,984,952,34,421,278,143,396,361,8,22,5,40
"2011","Stroud 014","E02004664","Total",2909,1887,890,997,33,585,448,137,368,338,1,26,3,36
"2011","Stroud 015","E02004665","Total",3543,2652,1421,1231,3,453,387,66,385,361,3,20,1,50
"2011","Tewkesbury 001","E02004666","Total",4600,3348,1146,2202,64,471,49,422,688,558,46,56,28,29
"2011","Tewkesbury 002","E02004667","Total",4819,3057,1679,1378,45,1014,148,866,650,577,9,49,15,53
"2011","Tewkesbury 003","E02004668","Total",3684,2671,1661,1010,76,393,64,329,458,410,11,24,13,86
"2011","Tewkesbury 004","E02004669","Total",2731,2244,1331,913,24,136,36,100,276,248,1,20,7,51
"2011","Tewkesbury 005","E02004670","Total",5574,4278,2191,2087,51,611,47,564,587,530,4,47,6,47
"2011","Tewkesbury 006","E02004671","Total",2480,1989,1124,865,9,139,37,102,311,291,4,11,5,32
"2011","Tewkesbury 007","E02004672","Total",5251,3890,1892,1998,12,465,97,368,837,551,153,43,90,47
"2011","Tewkesbury 008","E02004673","Total",2351,1755,1135,620,9,361,76,285,185,135,21,13,16,41
"2011","Tewkesbury 009","E02004674","Total",3636,2612,1232,1380,40,600,173,427,359,311,7,35,6,25
"2011","Mendip 001","E02006047","Total",3418,2531,1367,1164,4,264,89,175,533,468,18,40,7,86
"2011","Mendip 002","E02006048","Total",2714,1921,1017,904,10,399,88,311,335,285,13,30,7,49
"2011","Mendip 003","E02006049","Total",3167,2732,1410,1322,9,30,8,22,385,343,2,39,1,11
"2011","Mendip 004","E02006050","Total",3613,1959,881,1078,31,873,193,680,716,667,3,40,6,34
"2011","Mendip 005","E02006051","Total",3099,2413,1505,908,8,254,41,213,328,282,8,32,6,96
"2011","Mendip 006","E02006052","Total",3187,2404,1270,1134,9,189,54,135,532,478,13,30,11,53
"2011","Mendip 007","E02006053","Total",3848,2618,1216,1402,37,602,226,376,552,514,3,33,2,39
"2011","Mendip 008","E02006054","Total",3699,2506,1590,916,45,478,110,368,625,570,7,42,6,45
"2011","Mendip 009","E02006055","Total",3744,2310,1014,1296,69,582,123,459,744,692,4,45,3,39
"2011","Mendip 010","E02006056","Total",3068,2284,1219,1065,11,295,74,221,402,344,16,40,2,76
"2011","Mendip 011","E02006057","Total",3410,2160,1279,881,48,506,102,404,638,571,6,52,9,58
"2011","Mendip 012","E02006058","Total",3085,2486,1347,1139,16,176,38,138,367,332,4,30,1,40
"2011","Mendip 013","E02006059","Total",2673,2105,1288,817,11,137,31,106,327,291,17,16,3,93
"2011","Mendip 014","E02006060","Total",3432,2009,984,1025,41,688,143,545,652,612,1,34,5,42
"2011","Sedgemoor 001","E02006061","Total",3791,2915,1560,1355,24,328,215,113,472,419,10,36,7,52
"2011","Sedgemoor 002","E02006062","Total",4423,3660,2093,1567,32,213,85,128,466,407,14,41,4,52
"2011","Sedgemoor 003","E02006063","Total",2748,2364,1353,1011,10,111,81,30,223,187,1,31,4,40
"2011","Sedgemoor 004","E02006064","Total",3740,2618,1551,1067,6,295,155,140,774,718,6,44,6,47
"2011","Sedgemoor 005","E02006065","Total",3743,2334,1202,1132,44,756,440,316,571,517,6,45,3,38
"2011","Sedgemoor 006","E02006066","Total",3309,2654,1484,1170,42,346,258,88,230,197,6,23,4,37
"2011","Sedgemoor 007","E02006067","Total",2972,2289,1373,916,16,273,196,77,317,255,14,40,8,77
"2011","Sedgemoor 008","E02006068","Total",3092,1504,670,834,2,1000,724,276,542,484,2,50,6,44
"2011","Sedgemoor 009","E02006069","Total",4435,2295,966,1329,15,706,298,408,1355,1260,8,71,16,64
"2011","Sedgemoor 010","E02006070","Total",2955,2259,998,1261,19,114,74,40,546,490,8,44,4,17
"2011","Sedgemoor 011","E02006071","Total",3408,2734,1409,1325,2,160,76,84,484,444,4,33,3,28
"2011","Sedgemoor 012","E02006072","Total",3758,3131,1830,1301,20,219,142,77,331,289,5,31,6,57
"2011","Sedgemoor 013","E02006073","Total",2960,1423,591,832,6,1043,730,313,435,388,5,39,3,53
"2011","Sedgemoor 014","E02006074","Total",3467,2622,1240,1382,35,387,196,191,367,325,4,28,10,56
"2011","South Somerset 001","E02006075","Total",2099,1479,884,595,12,208,46,162,307,262,13,27,5,93
"2011","South Somerset 002","E02006076","Total",3660,2699,1602,1097,38,366,86,280,474,393,18,51,12,83
"2011","South Somerset 003","E02006077","Total",2444,1799,1104,695,11,306,86,220,282,255,2,20,5,46
"2011","South Somerset 004","E02006078","Total",2410,1813,1056,757,21,242,66,176,294,259,5,27,3,40
"2011","South Somerset 005","E02006079","Total",3114,2160,1222,938,7,384,102,282,498,444,9,38,7,65
"2011","South Somerset 006","E02006080","Total",2502,1645,895,750,6,279,61,218,525,278,146,22,79,47
"2011","South Somerset 007","E02006081","Total",2253,1749,1041,708,13,232,52,180,202,180,5,10,7,57
"2011","South Somerset 008","E02006082","Total",2840,2010,1115,895,30,426,85,341,331,288,3,31,9,43
"2011","South Somerset 009","E02006083","Total",2504,1812,959,853,22,344,109,235,287,250,6,26,5,39
"2011","South Somerset 010","E02006084","Total",3165,2374,1428,946,23,382,88,294,325,272,9,39,5,61
"2011","South Somerset 011","E02006085","Total",2549,1873,929,944,23,351,126,225,284,206,41,17,20,18
"2011","South Somerset 012","E02006086","Total",2706,2061,919,1142,19,257,89,168,345,272,27,23,23,24
"2011","South Somerset 013","E02006087","Total",2640,1460,596,864,55,588,207,381,518,398,48,34,38,19
"2011","South Somerset 014","E02006088","Total",3149,1675,782,893,40,1028,393,635,362,317,14,25,6,44
"2011","South Somerset 015","E02006089","Total",2939,1589,732,857,5,474,121,353,836,770,9,48,9,35
"2011","South Somerset 016","E02006090","Total",2985,2043,939,1104,29,403,111,292,468,430,1,34,3,42
"2011","South Somerset 017","E02006091","Total",4254,3082,1793,1289,32,614,191,423,432,368,10,42,12,94
"2011","South Somerset 018","E02006092","Total",2659,2222,1106,1116,16,120,29,91,288,262,2,21,3,13
"2011","South Somerset 019","E02006093","Total",3747,2685,1533,1152,22,494,121,373,496,438,5,43,10,50
"2011","South Somerset 020","E02006094","Total",2357,1740,1036,704,3,332,106,226,244,218,5,19,2,38
"2011","South Somerset 021","E02006095","Total",3585,2555,1415,1140,33,474,129,345,478,444,1,31,2,45
"2011","South Somerset 022","E02006096","Total",2849,2089,1062,1027,41,411,107,304,280,243,2,32,3,28
"2011","South Somerset 023","E02006097","Total",2933,1743,992,751,30,736,230,506,393,359,2,29,3,31
"2011","South Somerset 024","E02006098","Total",3158,2498,1578,920,11,246,70,176,323,275,15,32,1,80
"2011","Taunton Deane 001","E02006099","Total",2736,1998,917,1081,15,257,172,85,423,385,4,30,4,43
"2011","Taunton Deane 002","E02006100","Total",2955,2104,1082,1022,6,337,215,122,465,417,5,30,13,43
"2011","Taunton Deane 003","E02006101","Total",2420,1735,1031,704,21,294,245,49,324,285,8,27,4,46
"2011","Taunton Deane 004","E02006102","Total",3083,1521,704,817,12,1264,1104,160,230,207,1,18,4,56
"2011","Taunton Deane 005","E02006103","Total",3079,2503,1482,1021,31,222,179,43,288,254,4,22,8,35
"2011","Taunton Deane 006","E02006104","Total",3264,2289,988,1301,9,375,331,44,554,516,1,29,8,37
"2011","Taunton Deane 007","E02006105","Total",4680,2719,1217,1502,29,300,139,161,1568,1470,8,86,4,64
"2011","Taunton Deane 008","E02006106","Total",2991,2004,922,1082,11,607,442,165,345,265,32,23,25,24
"2011","Taunton Deane 009","E02006107","Total",3458,1490,621,869,15,1603,1298,305,289,261,4,22,2,61
"2011","Taunton Deane 010","E02006108","Total",4029,2320,1434,886,29,585,245,340,1017,906,34,50,27,78
"2011","Taunton Deane 011","E02006109","Total",3355,2857,1761,1096,13,78,61,17,361,324,9,26,2,46
"2011","Taunton Deane 012","E02006110","Total",3441,1982,828,1154,12,904,645,259,491,452,3,31,5,52
"2011","Taunton Deane 013","E02006111","Total",4322,3423,1979,1444,33,310,218,92,479,417,8,48,6,77
"2011","Taunton Deane 014","E02006112","Total",3094,2448,1363,1085,15,185,145,40,393,347,5,16,25,53
"2011","West Somerset 001","E02006113","Total",3340,2285,1458,827,19,256,24,232,728,655,9,60,4,52
"2011","West Somerset 002","E02006114","Total",2887,1831,1359,472,16,583,36,547,410,352,7,26,25,47
"2011","West Somerset 003","E02006115","Total",3254,2010,1237,773,17,762,65,697,413,357,12,27,17,52
"2011","West Somerset 004","E02006116","Total",3519,2542,1708,834,14,281,22,259,592,523,18,40,11,90
"2011","West Somerset 005","E02006117","Total",2623,1753,1262,491,6,406,34,372,367,302,23,30,12,91
"2011","Isle of Anglesey 001","W02000001","Total",3793,2572,1523,1049,4,605,542,63,518,445,1,60,12,94
"2011","Isle of Anglesey 002","W02000002","Total",2916,2298,1493,805,8,188,186,2,353,288,4,50,11,69
"2011","Isle of Anglesey 003","W02000003","Total",4673,2444,1266,1178,5,1292,1097,195,832,750,5,64,13,100
"2011","Isle of Anglesey 004","W02000004","Total",3241,2532,1576,956,9,286,260,26,341,283,7,45,6,73
"2011","Isle of Anglesey 005","W02000005","Total",3997,2974,1954,1020,14,358,312,46,547,490,7,46,4,104
"2011","Isle of Anglesey 006","W02000006","Total",2847,1832,1012,820,8,670,547,123,268,230,0,34,4,69
"2011","Isle of Anglesey 007","W02000007","Total",3003,1912,1089,823,6,421,355,66,583,434,65,33,51,81
"2011","Isle of Anglesey 008","W02000008","Total",2789,2009,1181,828,2,288,249,39,421,366,11,35,9,69
"2011","Isle of Anglesey 009","W02000009","Total",3335,2398,1350,1048,7,379,351,28,461,413,4,43,1,90
"2011","Gwynedd 001","W02000010","Total",2785,928,539,389,15,687,345,342,1083,1023,9,38,13,72
"2011","Gwynedd 002","W02000011","Total",3011,1649,839,810,7,825,466,359,450,381,20,39,10,80
"2011","Gwynedd 003","W02000012","Total",3546,2424,1202,1222,6,502,246,256,537,461,6,60,10,77
"2011","Gwynedd 004","W02000013","Total",2720,2024,1035,989,3,228,112,116,404,343,5,52,4,61
"2011","Gwynedd 005","W02000014","Total",2949,2052,1055,997,3,444,271,173,379,334,4,31,10,71
"2011","Gwynedd 006","W02000015","Total",3508,1995,1099,896,16,1096,605,491,307,264,2,33,8,94
"2011","Gwynedd 007","W02000016","Total",2767,1990,1125,865,10,398,223,175,314,264,5,38,7,55
"2011","Gwynedd 008","W02000017","Total",3335,2353,1358,995,8,571,306,265,334,283,2,45,4,69
"2011","Gwynedd 009","W02000018","Total",2997,2057,1350,707,9,461,253,208,387,348,0,30,9,83
"2011","Gwynedd 010","W02000019","Total",3218,2271,1557,714,8,398,160,238,444,362,10,57,15,97
"2011","Gwynedd 011","W02000020","Total",2958,2117,1439,678,11,373,180,193,379,318,7,41,13,78
"2011","Gwynedd 012","W02000021","Total",3654,2271,1462,809,15,646,340,306,629,540,13,59,17,93
"2011","Gwynedd 013","W02000022","Total",2881,2140,1480,660,9,276,133,143,368,307,7,47,7,88
"2011","Gwynedd 014","W02000023","Total",2698,1806,1307,499,10,345,136,209,452,378,12,40,22,85
"2011","Gwynedd 015","W02000024","Total",2556,1675,1125,550,8,371,173,198,410,330,9,60,11,92
"2011","Gwynedd 016","W02000025","Total",3160,1957,1312,645,14,554,280,274,559,490,7,56,6,76
"2011","Gwynedd 017","W02000026","Total",3730,2615,1884,731,19,386,156,230,624,552,16,49,7,86
"2011","Conwy 001","W02000027","Total",4228,2102,1254,848,14,674,234,440,1346,1270,9,53,14,92
"2011","Conwy 002","W02000028","Total",3043,2075,1258,817,16,615,286,329,305,276,2,26,1,32
"2011","Conwy 003","W02000029","Total",2806,2421,1452,969,25,11,0,11,313,286,5,22,0,36
"2011","Conwy 004","W02000030","Total",3002,1996,1252,744,31,387,154,233,539,493,2,36,8,49
"2011","Conwy 005","W02000031","Total",3606,2712,1467,1245,74,217,96,121,563,499,8,52,4,40
"2011","Conwy 006","W02000032","Total",3539,2851,1771,1080,32,234,76,158,376,337,2,32,5,46
"2011","Conwy 007","W02000033","Total",3002,1601,812,789,15,306,112,194,1037,994,4,35,4,43
"2011","Conwy 008","W02000034","Total",3258,2271,1109,1162,26,451,211,240,447,392,4,42,9,63
"2011","Conwy 009","W02000035","Total",3763,2573,1248,1325,34,642,393,249,476,428,3,40,5,38
"2011","Conwy 010","W02000036","Total",4986,3661,2306,1355,41,501,220,281,731,666,3,55,7,52
"2011","Conwy 011","W02000037","Total",3023,2153,1167,986,17,359,195,164,455,401,2,43,9,39
"2011","Conwy 012","W02000038","Total",2755,1970,1207,763,17,314,113,201,413,370,3,31,9,41
"2011","Conwy 013","W02000039","Total",3502,2482,1321,1161,15,422,164,258,531,471,1,52,7,52
"2011","Conwy 014","W02000040","Total",2807,1954,1174,780,5,274,143,131,473,410,5,48,10,101
"2011","Conwy 015","W02000041","Total",3857,2679,1611,1068,16,539,195,344,529,436,14,57,22,94
"2011","Denbighshire 001","W02000042","Total",2622,2004,1160,844,21,93,43,50,472,418,3,47,4,32
"2011","Denbighshire 002","W02000043","Total",2217,1496,786,710,35,341,212,129,305,274,2,28,1,40
"2011","Denbighshire 003","W02000044","Total",2391,2000,1187,813,17,35,11,24,319,287,4,26,2,20
"2011","Denbighshire 004","W02000045","Total",4084,1923,1007,916,35,727,200,527,1328,1263,16,45,4,71
"2011","Denbighshire 006","W02000047","Total",2058,1006,399,607,5,707,494,213,305,275,0,29,1,35
"2011","Denbighshire 008","W02000049","Total",2709,1947,989,958,15,315,250,65,367,324,6,31,6,65
"2011","Denbighshire 009","W02000050","Total",2789,2024,1069,955,11,263,212,51,459,414,11,33,1,32
"2011","Denbighshire 010","W02000051","Total",2263,1595,848,747,4,334,205,129,287,242,7,34,4,43
"2011","Denbighshire 011","W02000052","Total",2305,1171,584,587,15,649,431,218,424,379,6,29,10,46
"2011","Denbighshire 012","W02000053","Total",2631,2086,1087,999,13,203,99,104,288,249,3,31,5,41
"2011","Denbighshire 013","W02000054","Total",2460,1886,1060,826,6,202,155,47,315,265,10,37,3,51
"2011","Denbighshire 014","W02000055","Total",2406,1638,939,699,12,367,199,168,333,295,1,33,4,56
"2011","Denbighshire 015","W02000056","Total",2172,1592,868,724,6,264,201,63,256,217,8,24,7,54
"2011","Denbighshire 016","W02000057","Total",2786,1893,1158,735,16,405,255,150,400,362,6,25,7,72
"2011","Denbighshire 017","W02000419","Total",4653,3531,1796,1735,56,420,316,104,588,534,0,50,4,58
"2011","Flintshire 001","W02000058","Total",2291,1629,879,750,20,308,256,52,306,268,3,30,5,28
"2011","Flintshire 002","W02000059","Total",2691,2010,982,1028,19,384,335,49,251,209,5,32,5,27
"2011","Flintshire 003","W02000060","Total",4491,2816,1320,1496,16,1108,819,289,509,443,1,55,10,42
"2011","Flintshire 004","W02000061","Total",2862,1424,659,765,2,1116,920,196,298,256,2,33,7,22
"2011","Flintshire 005","W02000062","Total",2400,2047,905,1142,7,146,13,133,186,160,2,23,1,14
"2011","Flintshire 006","W02000063","Total",3506,2821,1479,1342,30,288,255,33,310,258,3,44,5,57
"2011","Flintshire 007","W02000064","Total",2596,1484,660,824,11,784,591,193,297,275,0,20,2,20
"2011","Flintshire 008","W02000065","Total",3000,2479,1065,1414,22,123,51,72,351,312,1,37,1,25
"2011","Flintshire 009","W02000066","Total",4150,2344,1032,1312,32,1191,826,365,545,493,6,37,9,38
"2011","Flintshire 010","W02000067","Total",2494,2156,982,1174,12,144,94,50,169,144,0,22,3,13
"2011","Flintshire 011","W02000068","Total",2453,1581,796,785,15,459,265,194,374,341,1,30,2,24
"2011","Flintshire 012","W02000069","Total",2524,2019,1004,1015,13,195,127,68,273,247,1,21,4,24
"2011","Flintshire 013","W02000070","Total",4266,3563,1662,1901,33,217,203,14,418,380,2,32,4,35
"2011","Flintshire 014","W02000071","Total",3049,2696,1389,1307,13,99,63,36,220,192,0,24,4,21
"2011","Flintshire 015","W02000072","Total",4668,3213,1301,1912,23,830,723,107,558,489,4,60,5,44
"2011","Flintshire 016","W02000073","Total",4313,2996,1638,1358,26,782,492,290,461,404,5,45,7,48
"2011","Flintshire 017","W02000074","Total",4098,2810,1326,1484,13,749,569,180,485,427,5,51,2,41
"2011","Flintshire 018","W02000075","Total",2224,1893,942,951,9,125,113,12,180,158,3,17,2,17
"2011","Flintshire 019","W02000076","Total",3169,2495,1337,1158,15,325,266,59,294,260,4,26,4,40
"2011","Flintshire 020","W02000077","Total",2536,1975,1039,936,9,278,228,50,244,198,5,37,4,30
"2011","Wrexham 003","W02000080","Total",3287,2170,873,1297,4,825,710,115,242,217,0,23,2,46
"2011","Wrexham 004","W02000081","Total",2331,1493,554,939,3,608,562,46,199,175,2,19,3,28
"2011","Wrexham 005","W02000082","Total",3171,1959,747,1212,12,849,701,148,312,271,3,37,1,39
"2011","Wrexham 006","W02000083","Total",3668,2364,974,1390,12,802,742,60,424,379,3,37,5,66
"2011","Wrexham 007","W02000084","Total",2240,1971,1091,880,3,81,57,24,148,123,1,22,2,37
"2011","Wrexham 008","W02000085","Total",3965,2908,1608,1300,3,428,296,132,572,521,1,44,6,54
"2011","Wrexham 009","W02000086","Total",2239,1385,712,673,6,599,574,25,208,180,1,25,2,41
"2011","Wrexham 010","W02000087","Total",2938,815,343,472,3,1923,1864,59,137,122,2,10,3,60
"2011","Wrexham 011","W02000088","Total",3515,1779,856,923,61,534,312,222,1083,1001,24,44,14,58
"2011","Wrexham 012","W02000089","Total",3781,1718,721,997,16,1181,848,333,791,747,5,35,4,75
"2011","Wrexham 013","W02000090","Total",2422,1668,825,843,10,566,468,98,145,126,0,15,4,33
"2011","Wrexham 014","W02000091","Total",2636,1963,965,998,18,349,304,45,273,217,3,47,6,33
"2011","Wrexham 015","W02000092","Total",3079,1654,718,936,11,985,811,174,377,334,2,38,3,52
"2011","Wrexham 016","W02000093","Total",2826,1866,879,987,7,478,356,122,426,389,5,30,2,49
"2011","Wrexham 017","W02000094","Total",3818,2067,1003,1064,7,1433,1390,43,245,212,1,28,4,66
"2011","Wrexham 018","W02000095","Total",2697,2016,1127,889,11,226,205,21,396,343,7,39,7,48
"2011","Wrexham 019","W02000096","Total",2839,1902,1003,899,9,582,415,167,267,233,4,29,1,79
"2011","Wrexham 020","W02000420","Total",5577,4574,2365,2209,15,354,327,27,530,472,6,46,6,104
"2011","Powys 001","W02000097","Total",3893,2843,1890,953,7,353,233,120,596,527,13,47,9,94
"2011","Powys 002","W02000098","Total",2641,2093,1213,880,11,158,126,32,334,292,5,30,7,45
"2011","Powys 003","W02000099","Total",2955,1596,919,677,23,712,286,426,537,493,8,26,10,87
"2011","Powys 004","W02000100","Total",2748,1892,1240,652,7,420,286,134,351,297,8,38,8,78
"2011","Powys 005","W02000101","Total",2350,1738,1055,683,1,165,144,21,405,356,16,29,4,41
"2011","Powys 006","W02000102","Total",2652,2008,1263,745,7,247,195,52,349,312,2,28,7,41
"2011","Powys 007","W02000103","Total",2349,1822,1167,655,8,194,140,54,268,229,6,30,3,57
"2011","Powys 008","W02000104","Total",2880,1719,1027,692,8,556,350,206,558,488,11,54,5,39
"2011","Powys 009","W02000105","Total",2135,889,393,496,8,983,637,346,223,199,1,22,1,32
"2011","Powys 010","W02000106","Total",2954,2091,1437,654,8,313,232,81,472,426,2,37,7,70
"2011","Powys 011","W02000107","Total",4449,3172,2245,927,12,491,339,152,649,571,14,60,4,125
"2011","Powys 012","W02000108","Total",3210,2331,1671,660,8,354,235,119,455,407,5,35,8,62
"2011","Powys 013","W02000109","Total",2583,1528,931,597,6,406,199,207,607,578,1,25,3,36
"2011","Powys 014","W02000110","Total",3072,2207,1459,748,5,288,177,111,512,464,11,29,8,60
"2011","Powys 015","W02000111","Total",3751,2587,1740,847,11,449,326,123,605,506,17,77,5,99
"2011","Powys 017","W02000113","Total",3635,2115,1301,814,13,804,462,342,612,451,56,50,55,91
"2011","Powys 018","W02000114","Total",2970,2217,1404,813,13,292,180,112,380,311,20,35,14,68
"2011","Powys 020","W02000414","Total",2565,1945,1269,676,13,148,118,30,391,333,9,42,7,68
"2011","Powys 021","W02000416","Total",4553,3297,2002,1295,10,828,706,122,334,282,2,48,2,84
"2011","Ceredigion 001","W02000116","Total",3291,2484,1509,975,11,191,56,135,549,493,11,37,8,56
"2011","Ceredigion 002","W02000117","Total",3321,1064,713,351,12,425,103,322,1759,1664,11,39,45,61
"2011","Ceredigion 003","W02000118","Total",2840,1535,865,670,14,644,203,441,594,515,10,39,30,53
"2011","Ceredigion 005","W02000120","Total",3257,2439,1586,853,10,173,40,133,562,492,4,54,12,73
"2011","Ceredigion 007","W02000122","Total",2921,2299,1561,738,10,176,54,122,351,296,7,41,7,85
"2011","Ceredigion 008","W02000123","Total",3432,2364,1609,755,18,356,127,229,627,550,4,55,18,67
"2011","Ceredigion 009","W02000124","Total",4165,2739,1811,928,16,670,242,428,669,619,8,37,5,71
"2011","Ceredigion 010","W02000125","Total",3308,2522,1671,851,6,332,111,221,384,335,1,40,8,64
"2011","Ceredigion 011","W02000421","Total",5027,3877,2496,1381,13,229,72,157,780,689,6,67,18,128
"2011","Pembrokeshire 001","W02000126","Total",3537,2801,1860,941,16,206,119,87,427,346,15,57,9,87
"2011","Pembrokeshire 002","W02000127","Total",4462,3187,2142,1045,12,586,337,249,594,517,7,61,9,83
"2011","Pembrokeshire 003","W02000128","Total",3130,2283,1510,773,16,439,299,140,315,247,14,43,11,77
"2011","Pembrokeshire 004","W02000129","Total",2807,2233,1425,808,5,157,101,56,331,283,6,39,3,81
"2011","Pembrokeshire 005","W02000130","Total",3118,1479,811,668,13,828,535,293,764,606,73,46,39,34
"2011","Pembrokeshire 006","W02000131","Total",3020,2055,1125,930,5,508,316,192,415,356,9,43,7,37
"2011","Pembrokeshire 007","W02000132","Total",2702,2023,1243,780,4,207,143,64,401,340,13,46,2,67
"2011","Pembrokeshire 008","W02000133","Total",3322,2572,1609,963,9,322,285,37,362,306,3,46,7,57
"2011","Pembrokeshire 009","W02000134","Total",3633,2759,1555,1204,7,518,358,160,305,265,0,37,3,44
"2011","Pembrokeshire 010","W02000135","Total",3097,1863,1060,803,3,808,573,235,391,338,6,45,2,32
"2011","Pembrokeshire 011","W02000136","Total",3708,2842,1856,986,14,268,164,104,512,450,13,38,11,72
"2011","Pembrokeshire 012","W02000137","Total",3047,1759,959,800,7,915,794,121,333,299,2,27,5,33
"2011","Pembrokeshire 013","W02000138","Total",4171,2459,1280,1179,9,899,569,330,768,705,6,53,4,36
"2011","Pembrokeshire 014","W02000139","Total",3318,2639,1669,970,11,314,234,80,306,256,8,36,6,48
"2011","Pembrokeshire 015","W02000140","Total",3046,1720,1000,720,2,883,664,219,393,356,11,22,4,48
"2011","Pembrokeshire 016","W02000141","Total",3004,1884,1203,681,7,454,331,123,571,510,10,43,8,88
"2011","Carmarthenshire 001","W02000142","Total",2406,1722,1086,636,9,347,304,43,276,240,7,22,7,52
"2011","Carmarthenshire 002","W02000143","Total",2516,1850,1258,592,5,254,181,73,333,276,9,32,16,74
"2011","Carmarthenshire 003","W02000144","Total",3274,2430,1524,906,14,360,279,81,407,353,5,49,0,63
"2011","Carmarthenshire 004","W02000145","Total",3124,2420,1561,859,9,228,178,50,407,351,4,50,2,60
"2011","Carmarthenshire 005","W02000146","Total",2732,2269,1425,844,7,145,109,36,264,223,3,34,4,47
"2011","Carmarthenshire 006","W02000147","Total",3221,2305,1300,1005,11,393,187,206,445,394,5,40,6,67
"2011","Carmarthenshire 007","W02000148","Total",2267,1397,803,594,2,550,375,175,283,255,4,23,1,35
"2011","Carmarthenshire 008","W02000149","Total",2945,1860,1220,640,9,436,308,128,586,543,8,32,3,54
"2011","Carmarthenshire 010","W02000151","Total",3209,2234,1270,964,5,632,494,138,288,251,3,28,6,50
"2011","Carmarthenshire 011","W02000152","Total",3387,2570,1427,1143,6,524,455,69,250,212,3,31,4,37
"2011","Carmarthenshire 012","W02000153","Total",3351,2667,1675,992,9,340,313,27,271,240,1,27,3,64
"2011","Carmarthenshire 013","W02000154","Total",3344,2287,1315,972,4,594,345,249,409,351,3,51,4,50
"2011","Carmarthenshire 015","W02000156","Total",3381,2638,1387,1251,8,356,305,51,334,303,5,22,4,45
"2011","Carmarthenshire 016","W02000157","Total",3845,2976,1670,1306,7,537,495,42,272,228,1,36,7,53
"2011","Carmarthenshire 017","W02000158","Total",2409,1926,973,953,6,201,176,25,247,210,0,31,6,29
"2011","Carmarthenshire 018","W02000159","Total",2575,1810,1057,753,3,474,390,84,245,216,5,21,3,43
"2011","Carmarthenshire 019","W02000160","Total",3193,2621,1456,1165,3,319,255,64,198,171,2,21,4,52
"2011","Carmarthenshire 020","W02000161","Total",2320,1437,742,695,2,550,464,86,288,243,10,19,16,43
"2011","Carmarthenshire 021","W02000162","Total",3781,2835,1684,1151,5,460,362,98,423,383,2,35,3,58
"2011","Carmarthenshire 022","W02000163","Total",2371,1595,910,685,4,360,252,108,366,330,0,27,9,46
"2011","Carmarthenshire 023","W02000164","Total",3035,2274,1346,928,7,310,241,69,383,348,1,29,5,61
"2011","Carmarthenshire 024","W02000165","Total",2827,1842,942,900,12,559,387,172,363,312,2,39,10,51
"2011","Carmarthenshire 025","W02000166","Total",3616,2316,1066,1250,12,933,846,87,295,259,1,32,3,60
"2011","Carmarthenshire 026","W02000167","Total",4551,2191,1184,1007,6,1250,755,495,1037,956,4,61,16,67
"2011","Carmarthenshire 027","W02000418","Total",5149,3854,2367,1487,13,560,377,183,631,548,10,59,14,91
"2011","Swansea 001","W02000168","Total",2661,1917,940,977,6,414,257,157,275,241,2,30,2,49
"2011","Swansea 002","W02000169","Total",4034,2863,1504,1359,7,678,506,172,410,359,6,40,5,76
"2011","Swansea 003","W02000170","Total",3868,2840,1411,1429,11,607,533,74,342,290,7,39,6,68
"2011","Swansea 004","W02000171","Total",3288,2671,1093,1578,8,219,119,100,347,317,2,24,4,43
"2011","Swansea 005","W02000172","Total",4201,2922,1348,1574,16,762,475,287,435,368,4,58,5,66
"2011","Swansea 006","W02000173","Total",2987,2278,838,1440,0,338,231,107,337,287,1,41,8,34
"2011","Swansea 007","W02000174","Total",3867,3142,1608,1534,8,399,333,66,276,233,3,37,3,42
"2011","Swansea 008","W02000175","Total",3416,2030,950,1080,9,697,341,356,630,580,1,35,14,50
"2011","Swansea 009","W02000176","Total",4011,2569,1460,1109,6,1113,735,378,273,230,2,34,7,50
"2011","Swansea 010","W02000177","Total",2982,2102,873,1229,20,442,262,180,391,351,0,37,3,27
"2011","Swansea 011","W02000178","Total",3753,1117,416,701,3,2295,1724,571,226,185,1,20,20,112
"2011","Swansea 012","W02000179","Total",2807,2256,1101,1155,5,213,155,58,295,259,1,32,3,38
"2011","Swansea 013","W02000180","Total",3416,1860,839,1021,9,1109,1024,85,366,322,5,38,1,72
"2011","Swansea 014","W02000181","Total",2980,1715,837,878,2,865,717,148,315,268,4,41,2,83
"2011","Swansea 015","W02000182","Total",3446,2419,1159,1260,3,420,221,199,550,484,1,64,1,54
"2011","Swansea 016","W02000183","Total",4279,2244,1102,1142,10,1016,493,523,926,828,3,86,9,83
"2011","Swansea 017","W02000184","Total",3176,2053,1033,1020,11,766,531,235,289,242,0,43,4,57
"2011","Swansea 018","W02000185","Total",2175,1803,1009,794,5,175,153,22,158,138,0,18,2,34
"2011","Swansea 019","W02000186","Total",3850,1163,564,599,6,2301,2164,137,256,225,1,26,4,124
"2011","Swansea 020","W02000187","Total",2373,1990,1135,855,10,170,57,113,182,152,2,28,0,21
"2011","Swansea 021","W02000188","Total",3321,1806,980,826,43,567,315,252,830,769,6,53,2,75
"2011","Swansea 022","W02000189","Total",3678,2342,1269,1073,6,916,599,317,349,301,10,36,2,65
"2011","Swansea 023","W02000190","Total",2027,1741,1012,729,3,81,4,77,180,147,1,24,8,22
"2011","Swansea 024","W02000191","Total",3916,2171,1126,1045,19,308,46,262,1354,1260,3,57,34,64
"2011","Swansea 025","W02000192","Total",5079,1366,748,618,26,1620,362,1258,1991,1863,8,84,36,76
"2011","Swansea 026","W02000193","Total",3609,1322,821,501,19,476,23,453,1739,1640,4,63,32,53
"2011","Swansea 027","W02000194","Total",2448,1943,1280,663,6,90,57,33,369,337,2,27,3,40
"2011","Swansea 028","W02000195","Total",2672,2340,1542,798,12,64,26,38,216,188,4,19,5,40
"2011","Swansea 029","W02000196","Total",3062,2154,1305,849,6,595,550,45,245,214,1,28,2,62
"2011","Swansea 030","W02000197","Total",2637,2296,1522,774,8,90,83,7,188,161,2,22,3,55
"2011","Swansea 031","W02000198","Total",3478,2824,1751,1073,5,72,8,64,520,449,2,61,8,57
"2011","Neath Port Talbot 002","W02000200","Total",2232,1578,952,626,1,462,302,160,158,133,1,23,1,33
"2011","Neath Port Talbot 003","W02000201","Total",2336,1610,940,670,4,419,258,161,267,229,0,32,6,36
"2011","Neath Port Talbot 004","W02000202","Total",4904,3539,1856,1683,5,846,521,325,429,369,1,49,10,85
"2011","Neath Port Talbot 005","W02000203","Total",2813,2021,1078,943,8,513,282,231,233,191,2,34,6,38
"2011","Neath Port Talbot 006","W02000204","Total",2940,2528,1358,1170,4,172,94,78,206,173,3,28,2,30
"2011","Neath Port Talbot 007","W02000205","Total",2595,1816,987,829,6,534,231,303,190,165,0,20,5,49
"2011","Neath Port Talbot 008","W02000206","Total",3367,1918,1099,819,7,800,358,442,569,520,1,41,7,73
"2011","Neath Port Talbot 009","W02000207","Total",2139,1889,984,905,2,107,76,31,116,99,2,12,3,25
"2011","Neath Port Talbot 010","W02000208","Total",3773,2775,1332,1443,11,505,377,128,431,352,5,68,6,51
"2011","Neath Port Talbot 011","W02000209","Total",2264,1364,882,482,1,680,491,189,172,134,2,32,4,47
"2011","Neath Port Talbot 012","W02000210","Total",2663,1626,803,823,10,750,597,153,226,200,3,22,1,51
"2011","Neath Port Talbot 013","W02000211","Total",3588,2064,1008,1056,8,884,573,311,575,533,4,28,10,57
"2011","Neath Port Talbot 014","W02000212","Total",3342,2330,1162,1168,4,731,558,173,222,190,0,31,1,55
"2011","Neath Port Talbot 015","W02000213","Total",2924,2448,1325,1123,7,240,161,79,190,160,0,28,2,39
"2011","Neath Port Talbot 016","W02000214","Total",4151,2371,1254,1117,7,1382,979,403,274,235,0,34,5,117
"2011","Neath Port Talbot 017","W02000215","Total",4234,2375,1264,1111,13,1004,670,334,729,672,10,40,7,113
"2011","Neath Port Talbot 018","W02000216","Total",3019,2264,1173,1091,6,186,90,96,509,461,2,44,2,54
"2011","Neath Port Talbot 019","W02000217","Total",2716,1962,891,1071,4,423,181,242,281,246,3,28,4,46
"2011","Neath Port Talbot 020","W02000417","Total",4393,3001,1628,1373,3,907,697,210,409,342,2,61,4,73
"2011","Bridgend 001","W02000218","Total",2966,2037,1101,936,7,372,147,225,506,452,3,45,6,44
"2011","Bridgend 002","W02000219","Total",3223,2325,1196,1129,7,456,153,303,397,354,0,32,11,38
"2011","Bridgend 003","W02000220","Total",3449,2474,1256,1218,8,444,111,333,488,438,2,45,3,35
"2011","Bridgend 004","W02000221","Total",3230,2165,1042,1123,5,607,160,447,417,362,1,51,3,36
"2011","Bridgend 005","W02000222","Total",2585,2029,1086,943,2,301,127,174,219,189,1,22,7,34
"2011","Bridgend 006","W02000223","Total",2337,1662,711,951,8,367,104,263,271,236,3,28,4,29
"2011","Bridgend 007","W02000224","Total",2556,1764,772,992,3,483,166,317,275,229,3,41,2,31
"2011","Bridgend 008","W02000225","Total",3783,2552,1120,1432,2,772,259,513,402,337,1,53,11,55
"2011","Bridgend 009","W02000226","Total",4163,3318,1539,1779,3,385,136,249,416,357,4,53,2,41
"2011","Bridgend 010","W02000227","Total",3023,1888,860,1028,4,746,350,396,338,298,1,33,6,47
"2011","Bridgend 011","W02000228","Total",2350,1921,1010,911,6,123,23,100,262,218,13,19,12,38
"2011","Bridgend 012","W02000229","Total",2616,1816,872,944,6,531,101,430,225,183,1,35,6,38
"2011","Bridgend 013","W02000230","Total",2171,1935,1022,913,1,32,14,18,178,147,5,22,4,25
"2011","Bridgend 014","W02000231","Total",3770,2175,1090,1085,9,861,211,650,674,601,2,54,17,51
"2011","Bridgend 015","W02000232","Total",2427,1932,722,1210,7,109,8,101,357,318,2,34,3,22
"2011","Bridgend 016","W02000233","Total",2602,1615,646,969,8,589,17,572,365,328,3,32,2,25
"2011","Bridgend 017","W02000234","Total",4112,3142,1155,1987,19,516,116,400,393,350,2,39,2,42
"2011","Bridgend 018","W02000235","Total",4073,3284,2025,1259,25,133,29,104,577,533,2,38,4,54
"2011","Bridgend 019","W02000236","Total",3079,2314,1234,1080,13,272,100,172,428,380,5,37,6,52
"2011","The Vale of Glamorgan 001","W02000237","Total",2158,1888,1086,802,0,53,45,8,181,162,4,9,6,36
"2011","The Vale of Glamorgan 002","W02000238","Total",2715,2284,1452,832,8,101,78,23,281,257,4,18,2,41
"2011","The Vale of Glamorgan 003","W02000239","Total",2688,2338,1278,1060,1,79,71,8,224,191,8,17,8,46
"2011","The Vale of Glamorgan 004","W02000240","Total",3628,2758,1347,1411,8,459,271,188,370,296,8,57,9,33
"2011","The Vale of Glamorgan 005","W02000241","Total",4554,3152,1651,1501,8,134,94,40,1192,1088,8,79,17,68
"2011","The Vale of Glamorgan 006","W02000242","Total",3333,2718,1531,1187,7,348,173,175,233,195,2,31,5,27
"2011","The Vale of Glamorgan 007","W02000243","Total",3784,1959,822,1137,5,1494,1178,316,293,253,4,33,3,33
"2011","The Vale of Glamorgan 008","W02000244","Total",4318,3461,1824,1637,8,406,213,193,405,360,4,39,2,38
"2011","The Vale of Glamorgan 009","W02000245","Total",3586,2357,749,1608,25,672,294,378,507,458,2,40,7,25
"2011","The Vale of Glamorgan 010","W02000246","Total",2347,2138,1140,998,6,63,58,5,125,104,2,19,0,15
"2011","The Vale of Glamorgan 011","W02000247","Total",3637,2834,1505,1329,7,338,313,25,423,338,39,38,8,35
"2011","The Vale of Glamorgan 012","W02000248","Total",4624,2831,1130,1701,14,511,202,309,1226,1140,5,67,14,42
"2011","The Vale of Glamorgan 013","W02000249","Total",3934,2348,977,1371,6,836,614,222,692,604,8,78,2,52
"2011","The Vale of Glamorgan 014","W02000250","Total",4307,3077,1323,1754,7,310,220,90,873,606,128,47,92,40
"2011","The Vale of Glamorgan 015","W02000251","Total",3892,2504,1139,1365,15,550,201,349,788,728,0,58,2,35
"2011","Cardiff 001","W02000367","Total",2456,2153,1156,997,17,21,12,9,231,211,3,16,1,34
"2011","Cardiff 002","W02000368","Total",2488,1976,783,1193,51,90,18,72,353,331,1,20,1,18
"2011","Cardiff 003","W02000369","Total",3115,2328,599,1729,35,195,5,190,534,501,4,27,2,23
"2011","Cardiff 004","W02000370","Total",2957,2704,1707,997,6,16,7,9,209,189,3,17,0,22
"2011","Cardiff 005","W02000371","Total",3989,2573,1126,1447,33,820,578,242,497,449,6,39,3,66
"2011","Cardiff 006","W02000372","Total",3060,2603,1206,1397,4,157,56,101,269,246,0,18,5,27
"2011","Cardiff 007","W02000373","Total",2668,1466,615,851,2,896,705,191,244,225,0,19,0,60
"2011","Cardiff 008","W02000374","Total",2293,2044,1135,909,5,41,12,29,176,160,1,12,3,27
"2011","Cardiff 009","W02000375","Total",2783,1634,488,1146,19,725,468,257,380,340,0,38,2,25
"2011","Cardiff 010","W02000376","Total",2989,2057,969,1088,9,639,381,258,256,230,0,23,3,28
"2011","Cardiff 011","W02000377","Total",2876,2139,584,1555,21,270,168,102,429,389,2,36,2,17
"2011","Cardiff 012","W02000378","Total",3096,2560,1338,1222,8,107,43,64,394,362,3,27,2,27
"2011","Cardiff 013","W02000379","Total",2562,789,250,539,21,1486,483,1003,228,203,0,23,2,38
"2011","Cardiff 014","W02000380","Total",2764,2407,1083,1324,2,102,86,16,224,198,10,13,3,29
"2011","Cardiff 015","W02000381","Total",2799,1737,825,912,8,725,635,90,272,232,0,39,1,57
"2011","Cardiff 016","W02000382","Total",2342,1142,504,638,9,944,624,320,189,163,0,19,7,58
"2011","Cardiff 017","W02000383","Total",3027,1887,750,1137,16,755,633,122,342,310,0,31,1,27
"2011","Cardiff 018","W02000384","Total",2322,1965,1017,948,15,94,40,54,231,204,3,24,0,17
"2011","Cardiff 019","W02000385","Total",2453,2040,1140,900,6,62,8,54,329,310,1,17,1,16
"2011","Cardiff 020","W02000386","Total",3349,2752,1543,1209,8,215,136,79,329,302,2,24,1,45
"2011","Cardiff 021","W02000387","Total",2419,1995,1054,941,6,55,30,25,342,311,9,19,3,21
"2011","Cardiff 022","W02000388","Total",2384,1845,896,949,1,299,175,124,222,192,2,26,2,17
"2011","Cardiff 023","W02000389","Total",3504,2112,895,1217,9,899,635,264,438,400,3,34,1,46
"2011","Cardiff 024","W02000390","Total",2365,2007,1176,831,9,102,9,93,228,209,2,14,3,19
"2011","Cardiff 025","W02000391","Total",2426,1179,516,663,18,251,158,93,928,812,5,68,43,50
"2011","Cardiff 026","W02000392","Total",3794,3047,1551,1496,9,142,13,129,539,499,5,32,3,57
"2011","Cardiff 027","W02000393","Total",2963,1791,739,1052,14,744,654,90,366,322,3,38,3,48
"2011","Cardiff 028","W02000394","Total",2739,890,460,430,16,81,15,66,1717,1617,0,86,14,35
"2011","Cardiff 029","W02000395","Total",2727,1733,750,983,3,242,8,234,724,685,4,34,1,25
"2011","Cardiff 030","W02000396","Total",2963,1229,552,677,18,160,77,83,1515,1428,3,67,17,41
"2011","Cardiff 031","W02000397","Total",2985,1876,888,988,8,733,438,295,309,274,1,30,4,59
"2011","Cardiff 032","W02000398","Total",3453,577,320,257,19,241,81,160,2544,2361,20,65,98,72
"2011","Cardiff 033","W02000399","Total",4602,1239,577,662,17,638,97,541,2656,2520,14,87,35,52
"2011","Cardiff 034","W02000400","Total",3147,1598,687,911,8,234,35,199,1269,1229,1,37,2,38
"2011","Cardiff 035","W02000401","Total",2688,1931,858,1073,4,246,32,214,469,440,1,18,10,38
"2011","Cardiff 036","W02000402","Total",4064,1318,488,830,19,1088,200,888,1551,1464,5,62,20,88
"2011","Cardiff 037","W02000403","Total",3077,1540,477,1063,5,981,652,329,487,434,1,50,2,64
"2011","Cardiff 038","W02000404","Total",2786,1256,486,770,5,902,78,824,561,506,3,45,7,62
"2011","Cardiff 039","W02000405","Total",2996,1012,384,628,4,1682,1596,86,248,228,0,14,6,50
"2011","Cardiff 040","W02000406","Total",3566,2304,998,1306,11,419,157,262,779,718,3,53,5,53
"2011","Cardiff 041","W02000407","Total",2637,1278,527,751,9,1036,712,324,267,235,3,25,4,47
"2011","Cardiff 042","W02000408","Total",3011,1050,492,558,15,795,277,518,1081,1025,2,39,15,70
"2011","Cardiff 043","W02000409","Total",2541,1521,674,847,6,779,652,127,188,156,0,28,4,47
"2011","Cardiff 044","W02000410","Total",3039,1594,694,900,9,486,143,343,881,816,5,40,20,69
"2011","Cardiff 045","W02000411","Total",2703,1437,545,892,7,892,519,373,331,288,0,41,2,36
"2011","Cardiff 046","W02000412","Total",2804,1517,613,904,11,560,233,327,646,604,3,31,8,70
"2011","Cardiff 048","W02000422","Total",3654,1172,282,890,54,214,21,193,2185,2086,4,89,6,29
"2011","Cardiff 049","W02000423","Total",4132,1258,391,867,30,1113,752,361,1633,1558,4,63,8,98
"2011","Rhondda Cynon Taf 001","W02000252","Total",3742,2403,1285,1118,0,936,647,289,323,291,0,25,7,80
"2011","Rhondda Cynon Taf 002","W02000253","Total",2722,1941,1059,882,2,237,112,125,501,463,2,33,3,41
"2011","Rhondda Cynon Taf 003","W02000254","Total",3356,2505,1322,1183,4,342,169,173,466,420,0,42,4,39
"2011","Rhondda Cynon Taf 004","W02000255","Total",2718,1909,1039,870,7,522,325,197,246,228,1,15,2,34
"2011","Rhondda Cynon Taf 005","W02000256","Total",4329,2897,1650,1247,7,647,202,445,721,669,0,44,8,57
"2011","Rhondda Cynon Taf 006","W02000257","Total",3282,2193,1230,963,4,544,274,270,484,463,0,20,1,57
"2011","Rhondda Cynon Taf 007","W02000258","Total",2573,1735,1077,658,3,368,147,221,413,380,0,30,3,54
"2011","Rhondda Cynon Taf 008","W02000259","Total",2427,1546,910,636,2,444,159,285,406,384,2,19,1,29
"2011","Rhondda Cynon Taf 009","W02000260","Total",2640,1726,1082,644,2,505,281,224,360,314,0,43,3,47
"2011","Rhondda Cynon Taf 010","W02000261","Total",3362,2567,1537,1030,5,245,70,175,495,444,0,48,3,50
"2011","Rhondda Cynon Taf 011","W02000262","Total",2322,1740,963,777,5,181,41,140,371,344,1,23,3,25
"2011","Rhondda Cynon Taf 012","W02000263","Total",2694,1869,965,904,4,349,176,173,431,387,0,37,7,41
"2011","Rhondda Cynon Taf 013","W02000264","Total",2657,1683,1012,671,4,390,225,165,548,499,1,36,12,32
"2011","Rhondda Cynon Taf 014","W02000265","Total",3944,2740,1529,1211,4,558,300,258,576,525,1,41,9,66
"2011","Rhondda Cynon Taf 015","W02000266","Total",3183,2220,1004,1216,7,623,384,239,296,266,0,27,3,37
"2011","Rhondda Cynon Taf 016","W02000267","Total",2804,2061,1169,892,4,173,46,127,529,485,1,41,2,37
"2011","Rhondda Cynon Taf 017","W02000268","Total",4030,3044,1629,1415,2,278,135,143,653,610,0,39,4,53
"2011","Rhondda Cynon Taf 018","W02000269","Total",3598,2524,1398,1126,3,444,228,216,558,490,1,61,6,69
"2011","Rhondda Cynon Taf 019","W02000270","Total",2888,2253,1117,1136,5,181,69,112,407,364,1,40,2,42
"2011","Rhondda Cynon Taf 020","W02000271","Total",2487,1537,843,694,3,573,403,170,328,297,0,31,0,46
"2011","Rhondda Cynon Taf 021","W02000272","Total",4294,3234,1647,1587,6,312,91,221,676,612,2,55,7,66
"2011","Rhondda Cynon Taf 022","W02000273","Total",3732,1730,875,855,9,975,360,615,931,881,2,38,10,87
"2011","Rhondda Cynon Taf 023","W02000274","Total",3921,2776,1249,1527,11,728,467,261,342,305,3,30,4,64
"2011","Rhondda Cynon Taf 024","W02000275","Total",2501,1722,878,844,3,494,260,234,237,205,1,28,3,45
"2011","Rhondda Cynon Taf 025","W02000276","Total",2518,2026,1185,841,2,314,203,111,144,127,0,15,2,32
"2011","Rhondda Cynon Taf 026","W02000277","Total",3098,2124,950,1174,16,602,293,309,307,272,0,30,5,49
"2011","Rhondda Cynon Taf 027","W02000278","Total",3623,3200,1189,2011,3,29,3,26,372,328,4,36,4,19
"2011","Rhondda Cynon Taf 028","W02000279","Total",3166,2384,961,1423,2,405,237,168,328,292,2,33,1,47
"2011","Rhondda Cynon Taf 029","W02000280","Total",3266,2483,993,1490,10,368,150,218,364,296,10,51,7,41
"2011","Rhondda Cynon Taf 030","W02000281","Total",3293,2487,1189,1298,4,403,164,239,354,312,7,32,3,45
"2011","Rhondda Cynon Taf 031","W02000282","Total",4493,3501,1402,2099,7,503,215,288,437,381,3,45,8,45
"2011","Merthyr Tydfil 002","W02000284","Total",4048,2537,1234,1303,6,892,308,584,541,486,3,42,10,72
"2011","Merthyr Tydfil 003","W02000285","Total",3385,2630,1414,1216,4,304,74,230,404,363,4,36,1,43
"2011","Merthyr Tydfil 004","W02000286","Total",2966,1432,811,621,6,1010,421,589,438,394,6,25,13,80
"2011","Merthyr Tydfil 005","W02000287","Total",3380,2643,1316,1327,6,292,146,146,385,346,5,33,1,54
"2011","Merthyr Tydfil 006","W02000288","Total",3512,2410,1377,1033,3,581,194,387,456,412,0,38,6,62
"2011","Merthyr Tydfil 007","W02000289","Total",3316,2493,1206,1287,7,429,127,302,342,311,2,27,2,45
"2011","Merthyr Tydfil 008","W02000415","Total",3657,1698,919,779,10,1610,1109,501,243,188,5,31,19,96
"2011","Caerphilly 001","W02000290","Total",3857,2232,1168,1064,3,1272,1105,167,309,279,2,23,5,41
"2011","Caerphilly 002","W02000291","Total",3151,2069,1116,953,7,645,538,107,402,357,1,37,7,28
"2011","Caerphilly 003","W02000292","Total",2432,1538,763,775,2,587,481,106,281,266,0,13,2,24
"2011","Caerphilly 004","W02000293","Total",2645,1729,910,819,3,523,488,35,373,350,0,21,2,17
"2011","Caerphilly 005","W02000294","Total",2363,1763,891,872,8,365,254,111,202,178,1,23,0,25
"2011","Caerphilly 006","W02000295","Total",3790,2895,1361,1534,9,529,367,162,324,283,1,35,5,33
"2011","Caerphilly 007","W02000296","Total",3214,2017,987,1030,6,847,585,262,311,279,5,24,3,33
"2011","Caerphilly 008","W02000297","Total",3214,2314,980,1334,7,502,375,127,358,317,0,39,2,33
"2011","Caerphilly 009","W02000298","Total",2940,2193,973,1220,7,406,289,117,310,280,0,28,2,24
"2011","Caerphilly 010","W02000299","Total",2743,1884,973,911,6,525,432,93,299,269,0,28,2,29
"2011","Caerphilly 011","W02000300","Total",3535,2424,1205,1219,5,721,587,134,355,324,2,28,1,30
"2011","Caerphilly 012","W02000301","Total",3039,2124,918,1206,9,599,372,227,284,254,1,24,5,23
"2011","Caerphilly 013","W02000302","Total",4114,3131,1527,1604,1,447,270,177,490,440,2,40,8,45
"2011","Caerphilly 014","W02000303","Total",2948,2105,949,1156,18,422,283,139,369,329,1,36,3,34
"2011","Caerphilly 015","W02000304","Total",2436,1627,772,855,2,467,290,177,317,278,0,38,1,23
"2011","Caerphilly 016","W02000305","Total",2743,1938,881,1057,23,531,413,118,233,207,0,25,1,18
"2011","Caerphilly 017","W02000306","Total",2364,1599,839,760,2,404,316,88,331,300,1,25,5,28
"2011","Caerphilly 018","W02000307","Total",2778,1828,737,1091,6,508,251,257,417,371,1,43,2,19
"2011","Caerphilly 019","W02000308","Total",3760,2612,1102,1510,6,727,531,196,393,360,0,28,5,22
"2011","Caerphilly 020","W02000309","Total",2837,2031,959,1072,5,498,397,101,269,240,1,25,3,34
"2011","Caerphilly 021","W02000310","Total",2215,1522,710,812,6,504,493,11,162,142,3,16,1,21
"2011","Caerphilly 022","W02000311","Total",4077,2422,1142,1280,61,1111,825,286,446,391,5,44,6,37
"2011","Caerphilly 023","W02000312","Total",3100,2207,980,1227,11,595,397,198,264,236,2,25,1,23
"2011","Caerphilly 024","W02000313","Total",4184,3428,1345,2083,3,227,125,102,496,448,3,44,1,30
"2011","Blaenau Gwent 001","W02000314","Total",3011,1861,974,887,3,912,450,462,204,171,0,23,10,31
"2011","Blaenau Gwent 002","W02000315","Total",2457,1473,749,724,1,585,276,309,378,341,3,24,10,20
"2011","Blaenau Gwent 003","W02000316","Total",3058,1866,1054,812,4,965,516,449,189,158,0,26,5,34
"2011","Blaenau Gwent 004","W02000317","Total",3283,2058,1024,1034,3,900,465,435,293,258,1,22,12,29
"2011","Blaenau Gwent 005","W02000318","Total",3959,2358,1171,1187,8,1123,547,576,433,366,5,45,17,37
"2011","Blaenau Gwent 006","W02000319","Total",3673,2223,1179,1044,8,863,399,464,540,487,2,44,7,39
"2011","Blaenau Gwent 007","W02000320","Total",3696,2414,1221,1193,4,569,207,362,670,611,4,45,10,39
"2011","Blaenau Gwent 008","W02000321","Total",3985,2573,1432,1141,2,732,284,448,630,580,2,40,8,48
"2011","Blaenau Gwent 009","W02000322","Total",3294,2058,1215,843,7,635,220,415,555,508,2,34,11,39
"2011","Torfaen 001","W02000323","Total",2645,1648,909,739,3,700,289,411,268,241,1,22,4,26
"2011","Torfaen 002","W02000324","Total",2938,1850,892,958,3,829,370,459,230,193,0,29,8,26
"2011","Torfaen 003","W02000325","Total",2923,1561,737,824,5,1120,548,572,201,174,1,21,5,36
"2011","Torfaen 004","W02000326","Total",3845,2638,1317,1321,18,679,254,425,454,421,3,22,8,56
"2011","Torfaen 005","W02000327","Total",2632,2102,1143,959,4,329,77,252,165,142,0,20,3,32
"2011","Torfaen 006","W02000328","Total",3043,2287,1067,1220,13,401,183,218,307,279,3,19,6,35
"2011","Torfaen 007","W02000329","Total",3233,1902,880,1022,32,942,387,555,332,289,2,29,12,25
"2011","Torfaen 008","W02000330","Total",3314,2403,1311,1092,7,570,197,373,296,254,2,37,3,38
"2011","Torfaen 009","W02000331","Total",2653,1314,464,850,4,1074,479,595,240,210,1,25,4,21
"2011","Torfaen 010","W02000332","Total",3127,1632,780,852,15,1152,538,614,280,236,2,36,6,48
"2011","Torfaen 011","W02000333","Total",2611,1865,665,1200,81,473,215,258,181,152,0,25,4,11
"2011","Torfaen 012","W02000334","Total",2753,2100,826,1274,4,466,169,297,174,152,1,16,5,9
"2011","Torfaen 013","W02000335","Total",2807,2216,1185,1031,10,365,134,231,187,151,0,30,6,29
"2011","Monmouthshire 001","W02000336","Total",3653,2735,1713,1022,13,295,76,219,551,480,18,41,12,59
"2011","Monmouthshire 002","W02000337","Total",3316,1974,1036,938,10,1045,411,634,252,218,2,28,4,35
"2011","Monmouthshire 003","W02000338","Total",3337,2598,1604,994,9,430,114,316,267,231,0,32,4,33
"2011","Monmouthshire 004","W02000339","Total",4520,3059,1741,1318,29,815,168,647,551,478,15,51,7,66
"2011","Monmouthshire 005","W02000340","Total",2971,2161,1371,790,4,210,59,151,492,445,7,30,10,104
"2011","Monmouthshire 006","W02000341","Total",3381,2633,1532,1101,14,285,82,203,392,344,10,35,3,57
"2011","Monmouthshire 007","W02000342","Total",3780,3243,1749,1494,16,174,33,141,298,277,3,15,3,49
"2011","Monmouthshire 008","W02000343","Total",3709,2245,1011,1234,13,805,200,605,605,542,3,52,8,41
"2011","Monmouthshire 009","W02000344","Total",3033,2596,1310,1286,8,201,81,120,195,171,5,15,4,33
"2011","Monmouthshire 010","W02000345","Total",3458,2400,1270,1130,15,764,311,453,251,215,5,29,2,28
"2011","Monmouthshire 011","W02000346","Total",3075,2498,932,1566,10,264,55,209,276,250,0,19,7,27
"2011","Newport 001","W02000347","Total",3433,2685,1375,1310,9,330,178,152,362,329,2,28,3,47
"2011","Newport 002","W02000348","Total",3363,2549,1341,1208,15,507,326,181,257,229,0,26,2,35
"2011","Newport 003","W02000349","Total",3306,1641,716,925,30,1343,843,500,251,220,0,20,11,41
"2011","Newport 004","W02000350","Total",2974,2422,1199,1223,3,289,194,95,222,200,2,15,5,38
"2011","Newport 005","W02000351","Total",2715,1700,776,924,11,739,410,329,219,193,0,24,2,46
"2011","Newport 006","W02000352","Total",3019,1693,712,981,14,787,222,565,467,421,3,39,4,58
"2011","Newport 007","W02000353","Total",2955,2152,1012,1140,10,142,59,83,620,559,3,53,5,31
"2011","Newport 008","W02000354","Total",2587,1739,945,794,5,577,175,402,217,197,0,16,4,49
"2011","Newport 009","W02000355","Total",3386,2895,1396,1499,2,224,140,84,240,222,0,17,1,25
"2011","Newport 010","W02000356","Total",2273,1096,549,547,4,1015,632,383,113,100,1,9,3,45
"2011","Newport 011","W02000357","Total",3289,2131,951,1180,18,263,76,187,827,782,3,37,5,50
"2011","Newport 012","W02000358","Total",2534,2094,1120,974,3,137,25,112,270,256,1,8,5,30
"2011","Newport 013","W02000359","Total",4074,2183,820,1363,52,571,222,349,1199,1126,6,56,11,69
"2011","Newport 014","W02000360","Total",2831,1270,580,690,33,486,70,416,1000,940,17,26,17,42
"2011","Newport 015","W02000361","Total",3977,2369,1175,1194,21,1227,688,539,309,263,0,36,10,51
"2011","Newport 016","W02000362","Total",2605,1922,923,999,26,352,197,155,269,243,2,18,6,36
"2011","Newport 017","W02000363","Total",2624,1735,869,866,10,630,326,304,201,179,0,16,6,48
"2011","Newport 018","W02000364","Total",2957,1017,411,606,8,1051,408,643,821,766,9,24,22,60
"2011","Newport 019","W02000365","Total",3077,1358,413,945,29,1321,738,583,320,292,0,21,7,49
"2011","Newport 020","W02000366","Total",3193,2621,946,1675,22,131,52,79,388,353,5,21,9,31
